Oracle Fusion Human Capital Management 11g Human Implementation Specialist Resources Certified	CERTIFICATION
Microsoft Certified Technology Specialist in SharePoint 2007 Application Development	CERTIFICATION
Oracle Certified Professional Internet Application Developer Release	CERTIFICATION
Oracle Certified Professional in R12 Implementation Expert	CERTIFICATION
Oracle Exadata Database Machine 2014 Certified Implementation Specialist	CERTIFICATION
Oracle 11i PL Developer Certified Associate	CERTIFICATION
Amazon web services AWS solution architect associate certified	CERTIFICATION
IBM Certified Systems Administrator on WebSphere Application Server	CERTIFICATION
QMSQMS Quality Management System ISO 9001 and ISO 9000-3 guidelines	CERTIFICATION
Certified in Pega Robotic Automation Architect Essentials Assessment	CERTIFICATION
Applications Programming, City and Guilds of London Institute, London	CERTIFICATION
Oracle BI Foundation Suite 11g Certified Implementation Specialist	CERTIFICATION
Microsoft Certified Design and implementing Databases	CERTIFICATION
Enterprise Manager 12c Cloud Certified Implementation specialist	CERTIFICATION
Certified Force.com Platform Developer	CERTIFICATION
SCM Supply Chain Management Certified Implementation champion	CERTIFICATION
DAT223.1x - Processing Big Data with Azure Data Lake Analytics	CERTIFICATION
Ruby Association Certified Ruby Programmer Silver Version 2.1	CERTIFICATION
Certified Force.com Platform Developer I	CERTIFICATION
Microsoft Certified Solutions Associate:  Server 2012 2014	CERTIFICATION
American Production and Inventory Control Society practitioner	CERTIFICATION
Introduction to project Management Principles and Practices	CERTIFICATION
Certified Field Service Lightning Consultant	CERTIFICATION
Microsoft certified HTML 5 with JavaScript and CSS3 Developer	CERTIFICATION
Palo alto accredited configuration engineer certified	CERTIFICATION
Oracle Certified Siebel Analytics Data Warehouse Developer	CERTIFICATION
Certified Force.com Administrator	CERTIFICATION
DAT223.3x - Orchestrating Big Data with Azure Data Factory	CERTIFICATION
Certified Force.com Administrator	CERTIFICATION
certified field service lighting in consultant	CERTIFICATION
VMware Certified Associate 5 - Data Center Virtualization	CERTIFICATION
Bachelors in Computer Science and Information Technology	DEGREE
Associate of Science in Engineering and Computer Science	DEGREE
Installing and Configuring the SAS Intelligence Platform	CERTIFICATION
Oracle Database 10g Administrator Certified Professional	CERTIFICATION
CERTIFIED PLATFORM DEVELOPER 1 DEV 401	CERTIFICATION
Diploma in Software Hardware Engineering and Management	DEGREE
CERTIFIED PLATFORM DEVELOPER I DEV 501	CERTIFICATION
Certified Field Service Lightning Consultant	CERTIFICATION
Automation Anywhere Certified Advanced RPA Professional	CERTIFICATION
Oracle Application Development Framework 11g Essentials	CERTIFICATION
Certified Force.com Platform Developer I	CERTIFICATION
Oracle Database 11g Certified Implementation Specialist	CERTIFICATION
Bachelor of  (Science|Engineering|Technology|commerce)	DEGREE
advanced RPA Professional in Automation Anywhere V10.0	CERTIFICATION
Certified Force.com Developer DEV 401	CERTIFICATION
Certified Platform Developer-1 DEV 401	CERTIFICATION
Professional certified Translation and Interpretation	CERTIFICATION
Certified Force.com Developer DEV-401	CERTIFICATION
Microsoft Certified Solution Developer MCSD in Net	CERTIFICATION
Certified Platform Developer DEV 401	CERTIFICATION
Certified Platform Developer DEV 401	CERTIFICATION
Oracle Database 11g Administrator Certified Associate	CERTIFICATION
Palo Alto Certified Network Security Engineer PCNSE	CERTIFICATION
Cisco Certified Network Associate Routing and Switching	CERTIFICATION
Oracle Master Certificate in Database Administration	CERTIFICATION
certified Force.com Developer DEV 401	CERTIFICATION
ITIL Foundation Certification for Service Management	CERTIFICATION
Palo Alto Certified Network Security Engineer PCNSE	CERTIFICATION
Oracle Certified Professional in Oracle 11g database	CERTIFICATION
Oracle Certified Professional in Oracle 10g database	CERTIFICATION
Oracle OEM 12c administration from Oracle University	CERTIFICATION
PeopleTools 8 Application Developer Certified Expert	CERTIFICATION
Microsoft Certified Application Development VBNet	CERTIFICATION
Certified Platform Developer 1 SP18	CERTIFICATION
Systems Analysis, National Computing Center London	CERTIFICATION
Certified Community Cloud Consultant	CERTIFICATION
Certified Platform Developer DEV401	CERTIFICATION
Oracle Certified Professional in Oracle 8i database	CERTIFICATION
Oracle Certified Professional in Oracle 9i database	CERTIFICATION
Oracle E-Business suite Essentials for Implementers	CERTIFICATION
Salesforce Certified Platform Developer I DEV-401	CERTIFICATION
Advanced Automation Anywhere Certified Professional	CERTIFICATION
Golden Gate 11g Certified implementation Specialist	CERTIFICATION
ISTQB - CERTIFIED TESTER FOUNDATION LEVEL  CTFL	CERTIFICATION
Checkpoint Certified Security Administrator CCSA	CERTIFICATION
Oracle Certified Siebel Analytics Server Architect	CERTIFICATION
Oracle Certified Professional in Oracle 8 database	CERTIFICATION
Certified Salesforce Admin certification	CERTIFICATION
Certified Salesforce developer certification	CERTIFICATION
NetApp Clustered Data ONTAP 8.2 Administration	CERTIFICATION
Certified Force.com Admin ADM	CERTIFICATION
ITIL Foundation Examination Trained and Certified	CERTIFICATION
Microsoft Certified Technology Specialist MCTS 	CERTIFICATION
Certified Service Cloud Consultant	CERTIFICATION
Checkpoint Certified Security Administrator CCSA	CERTIFICATION
Microsoft SharePoint Application Development 2010	CERTIFICATION
Law enforcement training and security operations	CERTIFICATION
Salesforce Certified App Builder Developer401	CERTIFICATION
Oracle Certified Associates 11G 12C Technologies	CERTIFICATION
Certified Salesforce Platform Developer 1 401	CERTIFICATION
Certified Salesforce Platform Developer	CERTIFICATION
Salesforce Certified Platform Developer DEV 401	CERTIFICATION
Salesforce Certified Community cloud consultant	CERTIFICATION
SALESFORCE CERTIFIED PLATFORM DEVELOPER 1 PD1	CERTIFICATION
Salesforce Certified Platform Developer I 401	CERTIFICATION
Certified Platform Developer 1	CERTIFICATION
Salesforce Certified Advanced Administrator 211	CERTIFICATION
Oracle Real Application Clusters Administration	CERTIFICATION
MCSA Microsoft Certified Solutions Associate	CERTIFICATION
PEGA ROBOTICS ARCHITECT ESSENTIAL PROFESSIONAL	CERTIFICATION
AWS CERTIFIED SOLUTION ARCHITECT Professional	CERTIFICATION
Hardware Training in IGEN Computer Educations	CERTIFICATION
Oracle Certified Associate OCA in Oracle 10g	CERTIFICATION
Certified Network Professional Security	CERTIFICATION
Certified Platform Developer I	CERTIFICATION
Certified Service Cloud Consultant	CERTIFICATION
Certified Platform Developer 1	CERTIFICATION
Solaris Certified System Administrator SCSA	CERTIFICATION
Full Stack Web Development Immersive Program	DEGREE
MCSA MCSE - MS Dynamics CRM 365 Fairfax VA	CERTIFICATION
Platform1 Developer certification	CERTIFICATION
CERTIFIED SYSOPS ADMINISTRATOR-ASSOCIATE	CERTIFICATION
Optimizing Dimensional Data Warehouse Design	CERTIFICATION
Check Point Certified Security Administrator	CERTIFICATION
Certified Force.com Developer	CERTIFICATION
Certified Force.com Administrator	CERTIFICATION
Oracle Certified Associate 11G Adminstration	CERTIFICATION
Financials Certified Implementation champion	CERTIFICATION
Oracle Applications Server Administrator 10g	CERTIFICATION
Certified Scrum Master CSM Scrum Alliance	CERTIFICATION
Certified Advanced Administrator	CERTIFICATION
AWS CERTIFIED SOLUTION ARCHITECT -ASSOCIATE	CERTIFICATION
Oracle 8i 9i and 11g Certified Professional	CERTIFICATION
Checkpoint Certified Security Administrator	CERTIFICATION
Certified Sales Cloud Consultant	CERTIFICATION
Certified Platform developer 401	CERTIFICATION
Oracle PL Developer Certified Associate	CERTIFICATION
Java SE 6 Programmer Certified Professional	CERTIFICATION
PL Developer Certified Associate OCA	CERTIFICATION
Cisco Certified Network Associate Security	CERTIFICATION
OCPOracle 11g Certified Professional-DBA	CERTIFICATION
Bachelor of Electrical Science Engineering	DEGREE
Electrical	O	ORGANIZATION
Cisco Certified Internetwork Expert CCIE	CERTIFICATION
Microsoft Certified System Engineer MCSE	CERTIFICATION
Oracle 10g new features for administrators	CERTIFICATION
Sales force Certified Platform Developer 1	CERTIFICATION
Platform App Builder CRT #402	CERTIFICATION
UiPath RPA Foundation Diploma Professional	CERTIFICATION
certified Platform Developer-I	CERTIFICATION
CERTIFIED PLATFORM APP BUILDER	CERTIFICATION
CERTIFIED PLATFORM DEVELOPER I	CERTIFICATION
Certified Platform Developer I	CERTIFICATION
Certified  Platform Developer I	CERTIFICATION
Professional in R12 Implementation Expert	CERTIFICATION
Certified Platform Developer 1	CERTIFICATION
ServiceNow Certified System Administrator	CERTIFICATION
Microsoft Certified Application Developer	CERTIFICATION
ServiceNow Certified System Administrator	CERTIFICATION
OCP Oracle Certification Exam Oracle 8i	CERTIFICATION
OCP Oracle 8 8i 9i 10g 11g Certified DBA	CERTIFICATION
Certified Platform Developer-1	CERTIFICATION
REDHAT 7 - CERTIFIED SYSTEM ADMINISTRATOR	CERTIFICATION
Certified  Platform Developer I	CERTIFICATION
Microsoft Certified Systems Administrator	CERTIFICATION
platform Developer I DEV 401	CERTIFICATION
Certified Network Associate	CERTIFICATION
ORACLE CERTIFIED JAVA PROFESSIONALOCJP	CERTIFICATION
Certified Software Quality AnalystCSQA	CERTIFICATION
PG Diploma in Computer ApplicationsMIS	DEGREE
Certified Platform Developer1	CERTIFICATION
REDHAT 7- CERTIFIED SYSTEM ADMINISTRATOR	CERTIFICATION
Certified Business Analysis Professional	CERTIFICATION
Certified Network Associate	CERTIFICATION
Certified Force.com Developer	CERTIFICATION
Network Systems Inplant training program	CERTIFICATION
UiPath RPA Developer Foundation Training	CERTIFICATION
Microsoft Certified System Administrator	CERTIFICATION
CERTIFIED DEVELOPER DEV 401	CERTIFICATION
Oracle eBusiness Procurement Proficiency	CERTIFICATION
Platform Developer 	CERTIFICATION
Certified Admin	CERTIFICATION
Certified Network Associate	CERTIFICATION
Exadata Storage Structure Admin I and II	CERTIFICATION
Exdata X3 and X4 Certified Administrator	CERTIFICATION
Accredited Configuration Engineer ACE	CERTIFICATION
Cisco	ORGANIZATION
Certified  Platform Developer	CERTIFICATION
Bachelor in (Commerce|Law|B.com|LL.B)	DEGREE
Master in Information System Management	DEGREE
Certified Platform Developer	CERTIFICATION
Certified ASQ Software Quality Engineer	CERTIFICATION
Cisco Certifies Network Associate CCNA	CERTIFICATION
ACE Accredited Configuration Engineer	CERTIFICATION
Certified Administration	CERTIFICATION
Certified Associate in Software Quality	CERTIFICATION
Certified  Developer – DEV401	CERTIFICATION
Certified Developer: DEV 401	CERTIFICATION
Certified Developer: DEV 401	CERTIFICATION
Administering Microsoft  Server 2012	CERTIFICATION
Associates in Applied Computer Science	DEGREE
SAS Platform Administration Fast Track	CERTIFICATION
Bachelor of Engineering and Technology	DEGREE
Certified Administrator	CERTIFICATION
EMC2 Cloud Infrastructure and services	CERTIFICATION
DEV 401 Certified Developer	CERTIFICATION
Oracle EBS R12.1 Purchasing Essentials	CERTIFICATION
Certified  Administrator	CERTIFICATION
Sales force Platform Administrator	CERTIFICATION
Oracle eBusiness Procurement Awareness	CERTIFICATION
Certified Administration	CERTIFICATION
Certified Platform Developer 1 PD 1	CERTIFICATION
SALESDORCE.COM CERTIFIED ADMINISTRTOR	CERTIFICATION
Project Management Professional PMP	CERTIFICATION
ServiceNow System Admin Certification	CERTIFICATION
Computer Learning Center Programming	CERTIFICATION
Certified Network Professional	CERTIFICATION
Project Management Professional	CERTIFICATION
Oracle Certified Professional OCP 8i	CERTIFICATION
Bachelors of Business Administration	DEGREE
Certified Information Systems Auditor	CERTIFICATION
Certified Information System Auditor	CERTIFICATION
Certified Developer PDI	CERTIFICATION
Microsoft Certified IT Professional 	CERTIFICATION
REDHAT 7 - CERTIFIED SYSTEM ENGINEER	CERTIFICATION
Administrator ADM	CERTIFICATION
Certified  Developer PD1	CERTIFICATION
Executive General Management Program	DEGREE
Computer Electronics and Networking	CERTIFICATION
Scaled Agile Framework SAFe Agilist	CERTIFICATION
REDHAT 7- CERTIFIED SYSTEM ENGINEER	CERTIFICATION
Bachelor of Business Administration	DEGREE
Masters Administration Technologies	DEGREE
IT Business Requirements Management	CERTIFICATION
Amazon Associate Solution Architect	CERTIFICATION
Fusion Financials and Manufacturing	CERTIFICATION
UiPath Orchestrator 2018.2 Training	CERTIFICATION
Oracle Database Backup and Recovery	CERTIFICATION
Certified Administrator	CERTIFICATION
Service Cloud ADM #261	CERTIFICATION
Dell Certified System Expert DCSE	CERTIFICATION
CERTIFIED ADMINISTRATOR	CERTIFICATION
Certified  Administrator	CERTIFICATION
Certified  Administrator	CERTIFICATION
Certified  Developer 401	CERTIFICATION
Certified Scaled Agile SAFe SA 4.0	CERTIFICATION
COBOL Programming and Applications	DEGREE
Informatica “PowerCenter 6 Basics”	CERTIFICATION
Certified SysOps Administrator	CERTIFICATION
AWS	ORGANIZATION
DISM	DEGREE
401 Certified  Developer	CERTIFICATION
Bachelor of Engineering Technology	DEGREE
Certified 401 Developer	CERTIFICATION
Certified Administrator	CERTIFICATION
DBA Masters Curriculum certificate	CERTIFICATION
Master of International Management	DEGREE
Certified Developer	CERTIFICATION
Project Management Institute PMI	ORGANIZATION
Certified  Developer	CERTIFICATION
ASM Agile Certified Scrum Master	CERTIFICATION
AWS Certified Developer- Associate	CERTIFICATION
401  Certified Developer	CERTIFICATION
Certified UI-PATH RPA Professional	CERTIFICATION
Sales force platform Developer 401	CERTIFICATION
Querying Microsoft  Server 2012	CERTIFICATION
Certified ServiceNow Administrator	CERTIFICATION
oracle RAC Certified Administrator	CERTIFICATION
Master in Computer Applications	DEGREE
AWS Certified Developer Associate	CERTIFICATION
Master of Business Administration	DEGREE
Master of Taxation	DEGREE
Candidate for	O	ORGANIZATION
Certified Network Associate	CERTIFICATION
RPA DEVELOPER FOUNDATION ADVANCED	CERTIFICATION
AWS Certified Solutions Architect	CERTIFICATION
Information Technology Project Management	SKILL	ORGANIZATION
Mathematics	SKILL	ORGANIZATION
Master in Business Administration	DEGREE
Dimensional Data Warehouse Design	CERTIFICATION
Certified Administrator	CERTIFICATION
AWS certified developer associate	CERTIFICATION
Microsoft Certified Professional 	CERTIFICATION
Scrum Product Owner Certification	CERTIFICATION
Microsoft certified C# Specialist	CERTIFICATION
AWS Solutions Architect Associate	CERTIFICATION
Sales cloud ADM #251	CERTIFICATION
EMC Information Storage Associate	CERTIFICATION
ServiceNow Implementation Partner	CERTIFICATION
professional Java SE6 programmer	CERTIFICATION
Cloud Computing Using Linux Unix	CERTIFICATION
Information Expert Systems IE440	CERTIFICATION
Certified Developer I	CERTIFICATION
Bachelor Business Administration	DEGREE
Bachelors in Information Systems	DEGREE
Certified App Builder	CERTIFICATION
Certified Developer 1	CERTIFICATION
Certified Developer 2	CERTIFICATION
Bachelor of Computer Application	DEGREE
Internal Six Sigma Certification	CERTIFICATION
AWS CERTIFIED SOLUTION ARCHITECT	CERTIFICATION
CERTIFICATION	O	ORGANIZATION
Certified in UiPath RPA Advanced	CERTIFICATION
Developer DEV – 401	CERTIFICATION
Certified  App Builder	CERTIFICATION
Platform Developer 1	CERTIFICATION
Platform Developer I	CERTIFICATION
Platform App Builder	CERTIFICATION
Oracle9i Certified Professional	CERTIFICATION
Master of Computer Applications	DEGREE
Information Technology	SKILL
Administrator	CERTIFICATION
Oracle Database  Fundamental	CERTIFICATION
data warehousing specialization	CERTIFICATION
SAFe 4.5 Certified Scrum Master	CERTIFICATION
Bachelor of Business Management	DEGREE
Palo Alto Network ACE certified	CERTIFICATION
Sun Java Certified Professional	CERTIFICATION
Blue Prism Accredited Developer	CERTIFICATION
Sun Certified Java Professional	CERTIFICATION
Citrix Certified Administration	CERTIFICATION
Project Monitoring and Evaluation	CERTIFICATION
Oracle SOA Suite 11g Essentials	CERTIFICATION
RMAN Backup and Recovery 10 11g	CERTIFICATION
Kanban Management Professional	CERTIFICATION
w3Schools JavaScript certified	CERTIFICATION
Certified  Admin	CERTIFICATION
Certified  Developer	CERTIFICATION
HP QUICK TEST PROFESSIONAL 9.2	CERTIFICATION
Master of Computer Application	DEGREE
VMware Certified Associate 6.0	CERTIFICATION
Certified Developer	CERTIFICATION
CompTIA Project Certification	CERTIFICATION
Relational Database Technology	CERTIFICATION
Oracle Data Gurad Replication 	CERTIFICATION
Fullstack Software Engineering	DEGREE
Force.com platform Developer I	CERTIFICATION
Professional Scrum MasterPSM	CERTIFICATION
Diploma in Project Management	CERTIFICATION
RPAIMPLEMENTATION METHODOLOGY	CERTIFICATION
Advanced Business Certificate	CERTIFICATION
Oracle Certified Professional	CERTIFICATION
Certified Scrum Product Owner	CERTIFICATION
VMware Certified Professional	CERTIFICATION
Oracle Certified Professional	CERTIFICATION
Project Planning and Management	CERTIFICATION
Certified Force.com Developer	CERTIFICATION
Java – Level 2 JSP and Servlets	CERTIFICATION
Bachelors of Computer Science	DEGREE
Business Information Systems	DEGREE
Certified Scrum Practitioner	CERTIFICATION
Computer Systems Engineering	DEGREE
Master in Computer Science	DEGREE
Control Language Programming	CERTIFICATION
ISTQB CERTIFIED PROFESSIONAL	CERTIFICATION
Project Management Institute	ORGANIZATION
Microsoft Certified Personal	CERTIFICATION
DEV 401 Certified	CERTIFICATION
Oracle Exalogic X2 Certified	CERTIFICATION
Project Manager Professional	CERTIFICATION
The Data Scientist’s Toolbox	CERTIFICATION
RDBMS and LINUX Administration	CERTIFICATION
Master in Computer Science	DEGREE
Bachelor of computer science	DEGREE
Certified Administrator	CERTIFICATION
CERTIFIED SCRUM MASTERCSM	CERTIFICATION
AUTOMATION ANYWHERE ADVANCE	CERTIFICATION
Quality Assurance Institute	ORGANIZATION
Masters of Computer Science	DEGREE
B.S. Electrical Engineering	DEGREE
Bachelor Computer Science	DEGREE
Bachelor of Engineering 	DEGREE
Defensive Driving Training	CERTIFICATION
Siebel CRM, Burlington, MA	CERTIFICATION
Certified Admin	CERTIFICATION
ITIL 2011 V3 Certification	CERTIFICATION
Red Hat Certified Engineer	CERTIFICATION
Scrum Master Certification	CERTIFICATION
PhD in Medicinal Chemistry	DEGREE
PeopleSoft Admin Certified	CERTIFICATION
Oracle Certified Associate	CERTIFICATION
Practical Machine Learning	CERTIFICATION
Bio-electrical Engineering	DEGREE
Oracle Database  Expert	CERTIFICATION
AWS Technical Professional	CERTIFICATION
Higher Secondary Education	DEGREE
Major in Computer Science	DEGREE
MS in Information Quality	DEGREE
PROFESSIONAL SCRUM MASTER	CERTIFICATION
Bachelor’s in Engineering	DEGREE
University of Connecticut	ORGANIZATION
Exploratory Data Analysis	CERTIFICATION
Getting and Cleaning Data	CERTIFICATION
Force.com Developer 401	CERTIFICATION
Certified Ethical Hacking	CERTIFICATION
Master Computer science	DEGREE
Bachelors in Engineering	DEGREE
Concepts and Programming	CERTIFICATION
Bachelor’s in Technology	DEGREE
Service Cloud	CERTIFICATION
Bachelors of Engineering	DEGREE
Sun Certified Programmer	CERTIFICATION
Certified Administrator	CERTIFICATION
Certified 501	CERTIFICATION
SAFe 4 Certified Agilist	CERTIFICATION
ServiceNow Administrator	CERTIFICATION
oracle 12c certified dba	CERTIFICATION
oracle 11g Certified Dba	CERTIFICATION
oracle 10g Certified Dba	CERTIFICATION
Business Administration	DEGREE
Certified Scrum Masters	CERTIFICATION
AWS Certified Developer	CERTIFICATION
Associate for OpenStack	CERTIFICATION
AWS Solutions Architect	CERTIFICATION
Oracle Fusion Certified	CERTIFICATION
Database Administration	CERTIFICATION
Forecasting in R-Studio	CERTIFICATION
Bachelor of Technology	DEGREE
Dover Business College	ORGANIZATION
Certified Scrum Master	CERTIFICATION
Bachelor of Technology	DEGREE
ESSENTIAL PROFESSIONAL	CERTIFICATION
Sales Cloud	CERTIFICATION
Database Administrator	CERTIFICATION
Masters in Electronics	DEGREE
Certified Cloud Master	CERTIFICATION
Certified Oracle 8 DBA	CERTIFICATION
Modern App Development	CERTIFICATION
Bachelor’s in commerce	DEGREE
Operations Management	DEGREE
Oracle Java Certified	CERTIFICATION
Certified ScrumMaster	CERTIFICATION
Bachelor of Fine Arts	DEGREE
Bachelors in Commerce	DEGREE
Post Graduate diploma	DEGREE
Bachelor of Fine Arts	DEGREE
Statistical Inference	CERTIFICATION
Reproducible Research	CERTIFICATION
Master of Engineering	DEGREE
Sales Force Certified	CERTIFICATION
Sales Force	ORGANIZATION
Secondary Examination	DEGREE
Doctor of Philosophy	DEGREE
TATA PRIVATE LIMITED	ORGANIZATION
PLATFORM DEVELOPER-I	CERTIFICATION
Bachelors of science	DEGREE
Six Sigma Green Belt	CERTIFICATION
Bachelors of Science	DEGREE
Master of Technology	DEGREE
Apptus Quote to Cash	CERTIFICATION
ITIL V3 intermediate	CERTIFICATION
Oracle DBA 10g 9i 8i	CERTIFICATION
Java SE 6 Programmer	CERTIFICATION
Associate in Science	DEGREE
ORCHESTRATOR 2018.2	CERTIFICATION
High School Diploma	DEGREE
Six Sigma Certified	CERTIFICATION
Secondary Education	DEGREE
First Aid Training	CERTIFICATION
ITIL V3 Foundation	CERTIFICATION
Basic Chef fluency	CERTIFICATION
ASSOCIATE OF ARTS 	DEGREE
Associates in Arts	DEGREE
Master of Science	DEGREE
BA in Criminology	DEGREE
DB2-730 Certified	CERTIFICATION
DB2 730 Certified	CERTIFICATION
Comptia Network 	CERTIFICATION
Trainings for AWS	CERTIFICATION
DB2 to Oracle database migration	CERTIFICATION	ORGANIZATION
Regression Models	CERTIFICATION
Oracle University	ORGANIZATION
Graduation CSE	DEGREE
Admin	CERTIFICATION
Bachelors in ECE	DEGREE
BUSINESS ANALYST	CERTIFICATION
Higher Secondary	DEGREE
SRE-RM Certified	CERTIFICATION
SRE-RM Certified	CERTIFICATION
AS Comp. Science	DEGREE
Bachelor of Engr	DEGREE
Google Analytics	CERTIFICATION
Admin	CERTIFICATION
BACHELOR OF ARTS	DEGREE
ITIl foundation	CERTIFICATION
Agile – AgileXP	CERTIFICATION
ISTQB Certified	CERTIFICATION
Bachelors in IT	DEGREE
Bachelors in IT	DEGREE
CCNA - Security	CERTIFICATION
BACHELOR OF ART	DEGREE
Data Processing	CERTIFICATION
fundamental	CERTIFICATION
Security IE420	CERTIFICATION
Certified POPM	CERTIFICATION
Data Analytics	CERTIFICATION
Chef Certified	CERTIFICATION
RDBMS Concepts	CERTIFICATION
UNIX internals	CERTIFICATION
BITECH	ORGANIZATION
LEAN Certified	CERTIFICATION
Oracle 11g DBA	CERTIFICATION
Oracle 10g DBA	CERTIFICATION
Oracle 12c DBA	CERTIFICATION
CompTIA Linux	CERTIFICATION
ISTQBCertified	CERTIFICATION
Oracle PL	CERTIFICATION
R Programming	CERTIFICATION
CCNP Security	CERTIFICATION
PMP Certified	CERTIFICATION
Oracle 9i DBA	CERTIFICATION
Oracle 8i DBA	CERTIFICATION
Undergraduate	DEGREE
Cgi scripting	CERTIFICATION
Data Science	CERTIFICATION
High School 	DEGREE
SAFe Agilist	CERTIFICATION
Microsoft C#	CERTIFICATION
Paloalto ACE	CERTIFICATION
Oracle 8 DBA	CERTIFICATION
Cloud Master	CERTIFICATION
Informix DBA	CERTIFICATION
CCNP Route	CERTIFICATION
Intermediate	DEGREE
App Academy	ORGANIZATION
Bachelor 	DEGREE
Tek Metrics	ORGANIZATION
Brain Bench	ORGANIZATION
Web methods	CERTIFICATION
Agile SAFe4	CERTIFICATION
QlikView 11	CERTIFICATION
IIT Madras 	ORGANIZATION
Bachelor’s	DEGREE
SharePoint	CERTIFICATION
MS. Office	CERTIFICATION
Brainbench	ORGANIZATION
SALESFORCE	ORGANIZATION
Salesforce.com	ORGANIZATION
Accounting	SKILL
Taxation	SKILL
Finance	SKILL
12th grade	DEGREE
10th grade	DEGREE
Oracle DBA	CERTIFICATION
Bachelor	DEGREE
NIIT Ltd.	ORGANIZATION
PMP	CERTIFICATION
PMI	CERTIFICATION
Microsoft 	ORGANIZATION
Tableau 10	CERTIFICATION
Oracle OCP	CERTIFICATION
Master’s 	DEGREE
Bachelor 	DEGREE
Bachelors	DEGREE
DESARROLL	ORGANIZATION
Rackspace	ORGANIZATION
Solaris 9	CERTIFICATION
REDHAT 7 	ORGANIZATION
ITIL V2.0	CERTIFICATION
MCSE 2003	CERTIFICATION
Security	CERTIFICATION
Bachelor	DEGREE
Bachelor of Engineering 	DEGREE
Oracle9i	ORGANIZATION
M. B. A.	DEGREE
B. B. A.	DEGREE
Power-BI	CERTIFICATION
Graduate	DEGREE
S.S.L.C.	DEGREE
SSLC    	DEGREE
Master 	DEGREE
UIPATH 	ORGANIZATION
TRAINEE	CERTIFICATION
Diploma	DEGREE
B. Tech	DEGREE
Masters	DEGREE
Oracle8	ORGANIZATION
Citrix 	ORGANIZATION
ASP.Net	SKILL
VCP-3.5	CERTIFICATION
S.S.L.C	DEGREE
B.Tech	DEGREE
BTech	DEGREE
RPG IV	DEGREE
Oracle	ORGANIZATION
B. Com	DEGREE
B-tech	DEGREE
OCA 9i	CERTIFICATION
M.Tech	DEGREE
AISSCE	DEGREE
M.Sc.	DEGREE
PGDBA	DEGREE
MCITP	CERTIFICATION
B.Sc.	DEGREE
B. S.	DEGREE
Ph.D.	DEGREE
CISSP	CERTIFICATION
PCNSE	CERTIFICATION
AISSE	DEGREE
H.S.C	DEGREE
B.S.	DEGREE
B.E.	DEGREE
M.S.	DEGREE
CCNA	CERTIFICATION
B.A.	DEGREE
RHCE	CERTIFICATION
CCNP	CERTIFICATION
NJIT	ORGANIZATION
Ph.D	DEGREE
CCDA	CERTIFICATION
CCDP	CERTIFICATION
CWNA	CERTIFICATION
CCIE	CERTIFICATION
A.S.	DEGREE
AS	DEGREE
BBA	DEGREE
B B A	DEGREE
B Com	DEGREE
B S	DEGREE
B Tech	DEGREE
BE	DEGREE
BS	DEGREE
Electrical	SKILL
BSc	DEGREE
M B A	DEGREE
MBA	DEGREE
MS	DEGREE
MSc	DEGREE
MTech	DEGREE
MCAD	CERTIFICATION
CISA	CERTIFICATION
CCSA	CERTIFICATION
CBAP	CERTIFICATION
Ph’d	DEGREE
NJIT	ORGANIZATION
MCSE	CERTIFICATION
SCSA	CERTIFICATION
DCSE	CERTIFICATION
KMP	CERTIFICATION
MBA	DEGREE
MCA	DEGREE
PMP	CERTIFICATION
BSc	DEGREE
AIS	CERTIFICATION
OCA	CERTIFICATION
BBA	DEGREE
PMP	CERTIFICATION
PhD	DEGREE
B.S	DEGREE
PGD	DEGREE
MIM	DEGREE
MCA	DEGREE
VCP	CERTIFICATION
ACE	CERTIFICATION
MSc	DEGREE
COM	CERTIFICATION
BCS	DEGREE
XII	DEGREE
HSC	DEGREE
SSC	DEGREE
BA	DEGREE
MS	DEGREE
BS	DEGREE
AA	DEGREE
BE	DEGREE
MA	DEGREE
VB	CERTIFICATION
X	DEGREE
Kendriya Vidyalaya	ORGANIZATION
VLSI Design	O	ORGANIZATION
Programming Language	O	ORGANIZATION
Jalandhar India	O	ORGANIZATION
Business Accounting for Managers	O	ORGANIZATION
Master of Science	DEGREE
Maths Physics and Chemistry	O	ORGANIZATION
LotVue	O	ORGANIZATION
PrettyPhoto Zebra Date Picker	O	ORGANIZATION
Vector Graphics	O	ORGANIZATION
Plugin Development	O	ORGANIZATION
SVG	O	ORGANIZATION
Asset Management	O	ORGANIZATION
Google Maps PC Miler	O	ORGANIZATION
Electronics and Communication	O	ORGANIZATION
Rajasthan Technical UniversityKota	ORGANIZATION	LOCATION
year	O	DURATION
RBSE	ORGANIZATION	LOCATION
CS	O	ORGANIZATION
TechnologyAggregate Percentage	O	ORGANIZATION
Tulsi Vidya Niketan Varanasi	ORGANIZATION	PERSON
Devasthaly Vidyapeeth Ballia	ORGANIZATION	PERSON
Science in Information Systems	O	ORGANIZATION
Big Data and Data Analytics	DESIGNATION
Topic	O	ORGANIZATION
CGPA	O	ORGANIZATION
Computer	O	ORGANIZATION
Computer Architecture	DESIGNATION	PERSON
Compiler Analysis of Algorithm 	O	ORGANIZATION
TEXAS	LOCATION	ORGANIZATION
and	O	ORGANIZATION
BE in Computer Science	DEGREE	ORGANIZATION
MS	DEGREE	ORGANIZATION
years	O	ORGANIZATION
Ph.D.	DEGREE	
CSE	O	ORGANIZATION
BA	DEGREE	ORGANIZATION
M.S.	DEGREE
B.E.	DEGREE
Information Technology Management GPA	O	ORGANIZATION
Web Analytics Data Visualization Agile Project Management System Analysis	DESIGNATION
Project Management Business Data Warehousing Quantitative Introduction	O	ORGANIZATION
Telecommunications GPA	O	ORGANIZATION
Electronics	O	ORGANIZATION
Google Analytics Qualification Tools	O	ORGANIZATION
Fullstack Software Engineering	DEGREE
Codesmith Labs	ORGANIZATION
Medium Daily Digest	O	ORGANIZATION
Rutgers	O	ORGANIZATION
Medium Daily Digest	O	ORGANIZATION
Bachelors of Science	DEGREE
Computer Science and Engineering	SKILL
Computer Science	SKILL
Mechanical Engineering	SKILL
Civil Engineering	SKILL
Electrical Engineering	SKILL
Electrical and Electronics Engineering	SKILL
Electronics and Telecommunications ENgineering	SKILL
Aerospace Engineering	SKILL
ELectrical Engineering	SKILL
Aeronautical Engineering	SKILL
Automobile Engineering	SKILL
Automation and Robotics	SKILL
ELectrical and Communication Engineering	SKILL
Mechatronics Engineering	SKILL
Electronics and Computer Engineering	SKILL
Chemical Engineering	SKILL
Electronics and Telecommunication Engineering	SKILL
Bachelor of Engineering	DEGREE
Communications	O	ORGANIZATION
Information Systems	SKILL	ORGANIZATION
Telecommunication	SKILL	ORGANIZATION
Information Assurance	SKILL
Information Systems SECURITY	SKILL
Electronics and Computer Science	SKILL
Bachelor	DEGREE
Bachelors of Engineering	DEGREE	
Master	DEGREE
Bachelor of Engr	DEGREE
Check Point	ORGANIZATION
OCP	CERTIFICATION
Certified Cloud Master	CERTIFICATION
CCSA	CERTIFICATION
NJIT	ORGANIZATION
Bachelor of science and technology	DEGREE
JNTU	ORGANIZATION
JNTUH	ORGANIZATION	
Bachelor of Science	DEGREE
Computer Technology	O	ORGANIZATION
Part Time Student	O	ORGANIZATION
Bachelor of Software Development	DEGREE
Computer Systems Engineering	DEGREE
Java SE6 programmer	CERTIFICATION
Bachelors in Computer Science	DEGREE
NEW ENGLAND COLLEGE	ORGANIZATION	LOCATION
Master of science	DEGREE
Linux Enterprise	O	ORGANIZATION
Goldman Sachs Sep	O	ORGANIZATION
Goldman Sachs Group Inc.	O	ORGANIZATION
Bulge Bracket Bank	O	ORGANIZATION
Treasury	O	ORGANIZATION
GS Bank USA	O	ORGANIZATION
Goldman Sachs	O	ORGANIZATION
Vanguard Group Malvern PA.	O	ORGANIZATION
EMS	O	ORGANIZATION
Uat	O	ORGANIZATION
AWS Jenkins Maven GitHub Nexus OSS	O	ORGANIZATION
Vanguard Group	O	ORGANIZATION
SSH Power	O	ORGANIZATION
Automation Continuous Integration	O	ORGANIZATION
Elastic Container Service	O	ORGANIZATION
PHP	O	ORGANIZATION
Amazon Machine Images	O	ORGANIZATION
TESE	ORGANIZATION	LOCATION
AWS	O	ORGANIZATION
VPC	O	ORGANIZATION
Grafana ELK Nexus OSS Jenkins Tomcat Shell Scripting Python Java Kafka	O	ORGANIZATION
IAM	O	ORGANIZATION
Dynamo	O	ORGANIZATION
EMS	O	ORGANIZATION
DevOps Engineer Medic Alert	O	ORGANIZATION
Devops Engineer	DESIGNATION
GILEAD	O	ORGANIZATION
Electronic Medical Records	O	ORGANIZATION
Source Tree& Stash	O	ORGANIZATION
Shell TFS Ansible JAVA	O	ORGANIZATION
Memorial Hermann Health	O	ORGANIZATION
GILEAD	O	ORGANIZATION
Electronic Medical Records	O	ORGANIZATION
Source Tree& Stash	O	ORGANIZATION
Shell TFS Ansible JAVA	O	ORGANIZATION
Memorial Hermann Health	O	ORGANIZATION
Build and Release Engineer	DESIGNATION
Release Engineer	DESIGNATION
Senior Linux Administrator	DESIGNATION
Linux Admin	DESIGNATION
Linux Administrator	DESIGNATION
Build and Release Engineer	DESIGNATION
Release Engineer	DESIGNATION
Senior Linux Administrator	DESIGNATION
Linux Administrator	DESIGNATION
CVS	O	ORGANIZATION
SCM	O	ORGANIZATION
Netcracker Technology Solutions Hyderabad India	O	ORGANIZATION
TFS CVS	O	ORGANIZATION
ANZ Bangalore India	O	ORGANIZATION
ANZ	O	ORGANIZATION
New Zealand Banking Group Limited	O	ORGANIZATION
2 weeks	O	ORGANIZATION
J.N.T.U.	ORGANIZATION
in Electrical &	O	ORGANIZATION
Jan 16	DATE
in	O	ORGANIZATION
& Communication -	O	ORGANIZATION
Bachelors of Technology	DEGREE
Masters	DEGREE
BA	DEGREE
UNIVERSITY OF TEXAS	ORGANIZATION
DAV Institute of Technology	ORGANIZATION
Telangana	O	PERSON
&	O	ORGANIZATION
Queens College	O	ORGANIZATION
Diploma	O	ORGANIZATION
INDIA	COUNTRY	LOCATION
Ahmedabad	O	LOCATION
Tech	O	ORGANIZATION
The University of Texas	ORGANIZATION	
CSS	O	ORGANIZATION
MY	O	ORGANIZATION
DVIR	O	ORGANIZATION
Google Maps	O	ORGANIZATION
Arkansas Tech University	ORGANIZATION	
USA	LOCATION	ORGANIZATION
Southern University and A&M College	ORGANIZATION
Malla Reddy Institute	O	ORGANIZATION
New Jersy	LOCATION	ORGANIZATION
University of Mumbai	ORGANIZATION
Data Visualization	O	ORGANIZATION
Agile Project Management	O
System Analysis	DESIGNATION
Project Management	DESIGNATION
Business Data Warehousing	DESIGNATION
Accounting for Managers University	O	ORGANIZATION	
University of Texas	ORGANIZATION	ORGANIZATION
IL	O	ORGANIZATION
BS	DEGREE
Associate in Science	DEGREE
Gandhi Institute of	O	ORGANIZATION
Management	O	ORGANIZATION
Instrumentation	O	ORGANIZATION
GITAM	ORGANIZATION	LOCATION
Bachelors	DEGREE
Information	O	ORGANIZATION
Data Analytics	DESIGNATION
1989	DATE
B.S.	DEGREE
Red Cross	O	ORGANIZATION
of Electronic	O	ORGANIZATION
Allendale	LOCATION	ORGANIZATION
w3Schools	ORGANIZATION
JNTUK	ORGANIZATION
AWS Solutions	ORGANIZATION
Architect Associate	CERTIFICATION
Platform1 Developer	CERTIFICATION
CBAP	CERTIFICATION
CSM	CERTIFICATION
Rackspace	ORGANIZATION
Associate for OpenStack	CERTIFICATION
Ruby Association	ORGANIZATION
Brain Bench Certified	ORGANIZATION
ANSI	O	ORGANIZATION
Oracle DBA	O	ORGANIZATION
Certified Administrator	CERTIFICATION
Certified Platform1 Developer	CERTIFICATION
Certified Platform Developer	CERTIFICATION
Salesforce	ORGANIZATION
Certified Developer	CERTIFICATION
Lead QA Test Analyst	DESIGNATION
Scrum Master	CERTIFICATION
SAFe	ORGANIZATION
Microsoft	ORGANIZATION
Designing Business Intelligence Infrastructure	DEGREE
Analyzing and Visualizing data	DEGREE
Business Intelligence Development	DEGREE
Master	DEGREE
Cisco	ORGANIZATION
Business Analytics	DESIGNATION
Chef Developer	CERTIFICATION
Splunk	ORGANIZATION
Certified User 6.x	DEGREE
Sales force	ORGANIZATION
Advanced Google Analytics	DEGREE
R programming	DEGREE
Statistical Inference	DEGREE
Platform App Builder	DEGREE
C# Specialist	DEGREE
HTML 5 with JavaScript CSS3 Developer	DEGREE
Sales cloud	DEGREE
Service Cloud	DEGREE
Science	O	ORGANIZATION
Oracle9i Certified Professional	DEGREE
Associate of Science	DEGREE
E-Business	ORGANIZATION
Field Service Lightning Consultant	DEGREE
Service Cloud Consultant	DEGREE
CCIE	CERTIFICATION
Sales force Admin	CERTIFICATION
Sales force Developer	CERTIFICATION
Developer	DEGREE
Checkpoint	ORGANIZATION
Palo Alto	ORGANIZATION
Sun certified	ORGANIZATION
SCJP	CERTIFICATION
Red Hat	ORGANIZATION
RHCE	DEGREE
ISTQB	DEGREE
Certified Scrum Master	CERTIFICATION
PMP	CERTIFICATION
Sun Java Certified	CERTIFICATION
CALIFORNIA UNIVERSITY OF MANAGEMENT	ORGANIZATION
M.S.	DEGREE
B.S.	DEGREE
Business Administration	O	ORGANIZATION
MBA	DEGREE
Jawaharlal Nehru Technological university	ORGANIZATION
PCNSE	DEGREE
Advanced RPA Professional	DEGREE
UiPath RPA Developer	DEGREE
UiPath Orchestrator	DEGREE
SALESFORCE	ORGANIZATION
PLATFORM DEVELOPER	DEGREE
ADMINISTRATOR	DESIGNATION
AWS	ORGANIZATION
UI-PATH RPA Professional	DEGREE
Independent Consultant	DESIGNATION
Senior Consultant	DESIGNATION
Senior Systems Project Leader	DESIGNATION
Technical Consultant	DESIGNATION
Solution Integrator	DESIGNATION
Software Tester	DESIGNATION
Product Engineer	DESIGNATION
Senior Systems Engineer	DESIGNATION
Unix Linux Administrator	DESIGNATION
Net Developer	DESIGNATION
Cisco Discovery Protocol	SKILL
Unix Administrator	DESIGNATION
NetC# Developer	DESIGNATION
Linux Unix Administrator	DESIGNATION
Linux Administrator	DESIGNATION	
Programmer	DESIGNATION
Solution Designer	DESIGNATION
software engineer	DESIGNATION
Full Stack Developer	DESIGNATION
Senior Android Developer	DESIGNATION
Product Engineer	DESIGNATION
Specialist Programmer	DESIGNATION
Solution Architect	DESIGNATION
Oracle DBA	DESIGNATION
Scrum Master and Project Manager	DESIGNATION
Senior Oracle DBA	DESIGNATION
Software Developer	DESIGNATION
Infrastructure Project Manager	DESIGNATION
Project Manager and Release Manager	DESIGNATION
Infrastructure Project Lead	DESIGNATION
Release Manager	DESIGNATION
OpenStack Intern	DESIGNATION
Business Analyst QA Testing Specialist Scrum Master	DESIGNATION
QA Testing Specialist	DESIGNATION
Business Analyst Data Analyst	DESIGNATION
Business Analyst Data Analyst	DESIGNATION
Business Analyst	DESIGNATION
Testing	DESIGNATION
Lead Oracle DBA	DESIGNATION
Oracle DBA Developer	DESIGNATION
Oracle SCM Functional Consultant	DESIGNATION
SCM Functional Consultant	DESIGNATION
SCM Functional Analyst	DESIGNATION
Analyst	DESIGNATION
Oracle Functional Analyst	DESIGNATION
Business Analyst QA Testing Specialist Scrum Master	DESIGNATION
QA Testing Specialist	DESIGNATION
Lead Oracle DBA	DESIGNATION
Oracle DBA Developer	DESIGNATION
Oracle SCM Functional Consultant	DESIGNATION
SCM Functional Consultant	DESIGNATION
SCM Functional Analyst	DESIGNATION
Analyst	DESIGNATION
Oracle Functional Analyst	DESIGNATION
Business Intelligence Analyst	DESIGNATION
University Graduate Research Assistant	DESIGNATION
Web Developer	DESIGNATION
Network Engineer	DESIGNATION
Network Engineer ADMINISTRATOR	DESIGNATION
Salesforce Consultant	DESIGNATION
Java Full Stack developer	DESIGNATION
Business and System Analyst	DESIGNATION
Junior Software Engineer	DESIGNATION
Salesforce Administrator	DESIGNATION
Principal Software Engineer	DESIGNATION
Linux Unix Administrator	DESIGNATION
Enterprise architect Tech Lead	DESIGNATION
Web architect developer	DESIGNATION
Technical specialist	DESIGNATION
Web architect Sr developer	DESIGNATION
Senior BI Consultant	DESIGNATION
Architect	DESIGNATION
Software programmer	DESIGNATION
Full Stack Java Developer	DESIGNATION 
QA Analyst	DESIGNATION
Lead Analyst	DESIGNATION
Java Developer Team Lead	DESIGNATION
QA Automation Engineer	DESIGNATION
QA Automation Engineer	DESIGNATION
Web architect	DESIGNATION
Tech Lead	DESIGNATION
Graduate Assistantship	DESIGNATION
Sr Net Developer	DESIGNATION
SrNetwork Security Engineer	DESIGNATION
Developer Trainee	DESIGNATION
Java Developer	DESIGNATION
Salesforce Lightning Developer	DESIGNATION
Trainee	DESIGNATION
CHECKPOINT SECURITY ENGINEER	DESIGNATION
eMatrix Consultant	DESIGNATION
developer	DESIGNATION
Tech Lead eMatrix	DESIGNATION
Enterprise architect	DESIGNATION
Tech Lead eMatrix Consultant	DESIGNATION
Tech Lead eMatrix Consultant	DESIGNATION
eMatrix Consultant Project Manager	DESIGNATION
eMatrix Consultant Project Manager	DESIGNATION
eMatrix Consultant	DESIGNATION
Salesforce Developer Analyst	DESIGNATION
Analyst	DESIGNATION
Salesforce CRM Developer	DESIGNATION
Salesforce Lead	DESIGNATION
Salesforce developer	DESIGNATION
Adobe Consultant	DESIGNATION 
Senior Application Developer	DESIGNATION
Digital Analyst	DESIGNATION
SSRS Developer	DESIGNATION
Adobe Analytics Consultant	DESIGNATION
Adobe Analyst	DESIGNATION
Adobe Analytics	DESIGNATION
Web Analytic Consultant	DESIGNATION
Net Web Developer	DESIGNATION
POWER BIDEVELOPER	DESIGNATION
Salesforce.com Developer	DESIGNATION
IT Manager Release Implementation Manager	DESIGNATION
Implementation Manager	DESIGNATION
Test Manager Consultant	DESIGNATION
Senior Peoplesoft Developer	DESIGNATION
Peoplesoft Developer	DESIGNATION
AWS Devops Engineer	DESIGNATION
Linux, System admin	DESIGNATION
System admin	DESIGNATION
Devops Engineer	DESIGNATION
PeopleSoft developer	DESIGNATION
VMware Windows Wintel-System Admin	DESIGNATION
VMware System Admin	DESIGNATION
Test Manager	DESIGNATION
SCM and Build Engineer	DESIGNATION
IT Manager	DESIGNATION
SalesforceDeveloper	DESIGNATION
QA Test Lead	DESIGNATION
Oracle DBA Consultant	DESIGNATION
Oracle DBA	DESIGNATION
Build Engineer	DESIGNATION
Oracle Apps DBA	DESIGNATION
Senior Net Developer	DESIGNATION
Oracle DBA Engineer	DESIGNATION
Lead Oracle Financials DBA	DESIGNATION
Oracle Database Administrator	DESIGNATION
Principal Oracle Database Administrator	DESIGNATION
Oracle Applications DBA and Identity Management specialist	DESIGNATION
Oracle Applications DBA	DESIGNATION
Management specialist	DESIGNATION
Oracle Financials DBA	DESIGNATION
Oracle Developer	DESIGNATION
Oracle Financials DBA Oracle operations DBA	DESIGNATION
Oracle operations DBA	DESIGNATION
Identity Management specialist	DESIGNATION
Solaris 9	CERTIFICATION
Developer	DESIGNATION
BI Developer	DESIGNATION
Python Developer	DESIGNATION
Jr  Developer	DESIGNATION
DevSecops Engineer	DESIGNATION
DevOps AWS Engineer	DESIGNATION
Senior OBIEE Developer	DESIGNATION
Siebel Analytics Developer	DESIGNATION
Full Stack Python Developer	DESIGNATION
AWS Engineer	DESIGNATION
Power BI Developer	DESIGNATION
Data Warehouse and BI Report Developer	DESIGNATION
BI Report Developer	DESIGNATION
MSBI Developer	DESIGNATION
Practical Machine Learning	CERTIFICATION
Senior Net Programmer Developer	DESIGNATION
Senior System Analyst and Net Programmer and Developer	DESIGNATION
Regression Models	CERTIFICATION
Basic Chef fluency	CERTIFICATION
EMC2 Cloud Infrastructure and services	CERTIFICATION
Principal Software Engineer	DESIGNATION
Linux Unix Administrator	DESIGNATION
Enterprise architect Tech Lead	DESIGNATION
Web architect Senior developer	DESIGNATION
Senior BI Consultant	DESIGNATION
Software programmer	DESIGNATION
Full Stack Java Developer	DESIGNATION 
QA Analyst	DESIGNATION
Lead Analyst	DESIGNATION
Java Developer Team Lead	DESIGNATION
QA Automation Engineer	DESIGNATION
QA Automation Engineer	DESIGNATION
Web architect	DESIGNATION
Tech Lead	DESIGNATION
Sr Net Developer	DESIGNATION
Sr Network Security Engineer	DESIGNATION
Developer Trainee	DESIGNATION
Java Developer	DESIGNATION
Trainee	DESIGNATION
CHECKPOINT SECURITY ENGINEER	DESIGNATION
eMatrix Consultant	DESIGNATION
developer	DESIGNATION
Tech Lead eMatrix	DESIGNATION
Enterprise architect	DESIGNATION
Tech Lead	DESIGNATION
eMatrix Consultant	DESIGNATION
eMatrix Consultant Project Manager	DESIGNATION
eMatrix Consultant	DESIGNATION
Salesforce Developer Analyst	DESIGNATION
Analyst	DESIGNATION
Salesforce CRM Developer	DESIGNATION
Senior Application Developer	DESIGNATION
SSRS Developer	DESIGNATION
Net Web Developer	DESIGNATION
Senior Salesforce Developer Admin	DESIGNATION
Lead Salesforce.com Developer Administrator	DESIGNATION
Salesforce.com Developer Administrator	DESIGNATION
Salesforce.com Developer	DESIGNATION
IT Manager Release Implementation Manager	DESIGNATION
Implementation Manager	DESIGNATION
Test Manager Consultant	DESIGNATION
Senior Peoplesoft Developer	DESIGNATION
Peoplesoft Developer	DESIGNATION
AWS Devops Engineer	DESIGNATION
PeopleSoft developer	DESIGNATION
Test Manager	DESIGNATION
SCM and Build Engineer	DESIGNATION
IT Manager	DESIGNATION
SalesforceDeveloper	DESIGNATION
QA Test Lead	DESIGNATION
Oracle DBA Consultant	DESIGNATION
Build Engineer	DESIGNATION
Oracle Apps DBA	DESIGNATION
Senior Net Developer	DESIGNATION
Oracle DBA Engineer	DESIGNATION
Oracle Database Administrator	DESIGNATION
Principal Oracle Database Administrator	DESIGNATION
Solaris 9	CERTIFICATION
Developer	DESIGNATION
BI Developer	DESIGNATION
Python Developer	DESIGNATION
Power BI Developer	DESIGNATION
Power BI Developer	DESIGNATION
MSBI Developer	DESIGNATION
Practical Machine Learning	CERTIFICATION
Senior Net Programmer	DESIGNATION
Senior Net Developer	DESIGNATION
Senior System Analyst and Net Programmer and Developer	DESIGNATION
Regression Models	CERTIFICATION
Basic Chef fluency	CERTIFICATION
QA Tester	DESIGNATION
Quality Analyst	DESIGNATION
DB Engineer Scrum Master	DESIGNATION
J2EE Programmer	DESIGNATION
Senior Lead Full Stack Engineer	DESIGNATION
Business System Analyst	DESIGNATION
Business System Analyst Web developer	DESIGNATION
Operations Engineer	DESIGNATION
Operations Engineer	DESIGNATION
Network Security Engineer	DESIGNATION
Statistical Inference	CERTIFICATION
Exploratory Data Analysis	CERTIFICATION
Getting and Cleaning Data	CERTIFICATION
Linux System Administrator	DESIGNATION
System Administrator	DESIGNATION
Lead Developer	DESIGNATION
Principal Consultant	DESIGNATION 
Senior Oracle Financials Consultant	DESIGNATION
Salesforce Developer Lightning Developer	DESIGNATION
Software Engineer	DESIGNATION
Software Engineer Web Designer and Web developer	DESIGNATION
Oracle Financials Analyst II	DESIGNATION
Software Developer	DESIGNATION
Oracle Financials Functional Consultant	DESIGNATION
Senior Oracle Cosultant	DESIGNATION
Senior Oracle Techno-Functional Consultant	DESIGNATION
Software Engineer Application Developer	DESIGNATION
Oracle EBS Techinical Consultant	DESIGNATION 
Functional Consultant	DESIGNATION
Java developer	DESIGNATION	PERSON
Functional Business Analyst	DESIGNATION
AWS Sysops Admin	DESIGNATION
Sysops Admin	DESIGNATION
Android Developer	DESIGNATION
Fullstack Net Developer	DESIGNATION
Net Developer	DESIGNATION
Salesforce Administrator	DESIGNATION
Android Lead	DESIGNATION
Splunk Analyst	DESIGNATION
Cloud DevOps Engineer	DESIGNATION
Cloud DevOps Engineer	DESIGNATION
Splunk Admin	DESIGNATION
ServiceNow Administrator Developer	DESIGNATION
Web UI Developer	DESIGNATION
ITSM CONSULTANT	DESIGNATION
BMC Remedy ITSM CONSULTANT	DESIGNATION
Splunk Engineer	DESIGNATION
UI Developer	DESIGNATION
Firewall Engineer	DESIGNATION
Security Splunk Engineer	DESIGNATION	
Power BI MSBI DEVELOPER	DESIGNATION
DEVELOPER	DESIGNATION
Sr Network Engineer	DESIGNATION
Developer	DESIGNATION
MSBI DEVELOPER	DESIGNATION
MSBI Developer	DESIGNATION
APPLICATION SUPPORT ENGINEER	DESIGNATION
Application Support Engineer	DESIGNATION
iOS Developer	DESIGNATION
Android Developer	DESIGNATION
Windows Active Directory Engineer	DESIGNATION
Active Directory Engineer	DESIGNATION
Oracle E-Business Suite Functional Test Analyst	DESIGNATION
Oracle Business System Analyst	DESIGNATION
Sr Salesforce Lightning Admin Developer	DESIGNATION
Automation Test Engineer	DESIGNATION
Software Tester	DESIGNATION
Financial Center Manager	DESIGNATION
Oracle Business Analyst	DESIGNATION
Business Analyst	DESIGNATION
Team Lead Delivery Management Associate	DESIGNATION
Delivery Management Associate	DESIGNATION
Application Developer	DESIGNATION
Implementation Tech Lead Data Analyst	DESIGNATION
Teaching Assistant	DESIGNATION
Front End UI Developer	DESIGNATION
Front End	SKILL
UI Developer	DESIGNATION
Quality Analyst	DESIGNATION
DB Engineer Scrum Master	DESIGNATION
J2EE Programmer	DESIGNATION
Senior Lead Full Stack Engineer	DESIGNATION
Operations Engineer	DESIGNATION
Operations Engineer	DESIGNATION
Network Security Engineer	DESIGNATION
Statistical Inference	CERTIFICATION
Exploratory Data Analysis	CERTIFICATION
Getting and Cleaning Data	CERTIFICATION
Linux System Administrator	DESIGNATION
System Administrator	DESIGNATION
Lead Developer	DESIGNATION
Principal Consultant	DESIGNATION 
Full-Stack Python Developer	DESIGNATION
Senior Oracle Financials Consultant	DESIGNATION
QA Automation Tester	DESIGNATION
Automation Tester	DESIGNATION
SDET	DESIGNATION
Automation Tester	DESIGNATION
Senior QA Automation Engineer	DESIGNATION
Network Associate	DESIGNATION
Senior Network Engineer	DESIGNATION
Salesforce Developer Lightning Developer	DESIGNATION
Oracle Financials Analyst II	DESIGNATION
Business Applications Specialist	DESIGNATION
Selenium Test Engineer	DESIGNATION
Accounting Manager	DESIGNATION
Software Developer	DESIGNATION
Oracle Financials Functional Consultant	DESIGNATION
Senior Oracle Cosultant	DESIGNATION
Senior Oracle Techno-Functional Consultant	DESIGNATION
Software Engineer Application Developer	DESIGNATION
Software Development Engineer	DESIGNATION
Oracle EBS Techinical Consultant	DESIGNATION 
Functional Consultant	DESIGNATION
Java developer	DESIGNATION	PERSON
Functional Business Analyst	DESIGNATION
Android Developer	DESIGNATION
Salesforce Administrator	DESIGNATION
Android Lead	DESIGNATION
Splunk Analyst	DESIGNATION
Cloud Engineer	DESIGNATION
DevOps Enginner	DESIGNATION
Cloud Engineer	DESIGNATION
Devops Engineer	DESIGNATION
Splunk Admin	DESIGNATION
ServiceNow Administrator Developer	DESIGNATION
Web UI Developer	DESIGNATION
ITSM CONSULTANT	DESIGNATION
BMC Remedy ITSM CONSULTANT	DESIGNATION
Splunk Engineer	DESIGNATION
UI Developer	DESIGNATION
Firewall Engineer	DESIGNATION
Security Splunk Engineer	DESIGNATION	
Power BI DEVELOPER	DESIGNATION
Power MSBI Developer	DESIGNATION
DEVELOPER	DESIGNATION
Sr Network Engineer	DESIGNATION
Developer	DESIGNATION
MSBI DEVELOPER	DESIGNATION
MSBI Developer	DESIGNATION
APPLICATION SUPPORT ENGINEER	DESIGNATION
Application Support Engineer	DESIGNATION
iOS Developer	DESIGNATION
Android Developer	DESIGNATION
Oracle E-Business Suite Functional Test Analyst	DESIGNATION
Oracle Business System Analyst	DESIGNATION
Sr Salesforce Lightning Admin Developer	DESIGNATION
Automation Test Engineer	DESIGNATION
Software Tester	DESIGNATION
Financial Center Manager	DESIGNATION
Oracle Business Analyst	DESIGNATION
Business Analyst	DESIGNATION
Team Lead Delivery Management Associate	DESIGNATION
Delivery Management Associate	DESIGNATION
Application Developer	DESIGNATION
Implementation Tech Lead Data Analyst	DESIGNATION
Teaching Assistant	DESIGNATION
Front End UI Developer	DESIGNATION
UI Developer	DESIGNATION
Jr Net Developer	DESIGNATION
FullStack Dotnet Developer	DESIGNATION
Network Engineer	DESIGNATION
FullStack Dotnet Developer	DESIGNATION
Dotnet Developer	DESIGNATION
Net Programmer	DESIGNATION
DOTNET Developer	DESIGNATION
Net Developer	DESIGNATION	PERSON
SFDC Administrator Developer	DESIGNATION
Automaton Anywhere Blue Prism	DESIGNATION
MSBI Full stack developer	DESIGNATION
Associate Manger	DESIGNATION
Solution Architect	DESIGNATION
Senior Report Analyst	DESIGNATION
BI Tableau Developer Data Analyst	DESIGNATION
Senior Systems Analyst	DESIGNATION
Industrial Systems Engineer	DESIGNATION
Weapon Systems Engineer	DESIGNATION
BI Lead Developer	DESIGNATION
Data Analyst	DESIGNATION
BI Tableau Developer	DESIGNATION
BI Developer Data Analyst	DESIGNATION
JuniorNet Developer	DESIGNATION
Python Developer	DESIGNATION
Systems Database Engineer	DESIGNATION
Database Engineer	DESIGNATION
Computer Scientist	DESIGNATION
Senior Software Quality Engineer	DESIGNATION
Owner and Oracle Consultant	DESIGNATION
Senior Engineer	DESIGNATION
Senior Analyst	DESIGNATION
Systems Engineer and Software Application Developer	DESIGNATION
Python Developer	DESIGNATION	PERSON
Python Programmer	DESIGNATION
Web Developer	DESIGNATION
FullStack Dotnet Developer	DESIGNATION
Senior Computer Scientist	DESIGNATION
Owner	DESIGNATION
FullStack Dotnet Developer	DESIGNATION
Dotnet Developer	DESIGNATION
Net Programmer	DESIGNATION
DOTNET Developer	DESIGNATION
Automaton	SKILL
Blue Prism	SKILL
Senior Report Analyst	DESIGNATION
BI Tableau Developer	DESIGNATION
Data Analyst	DESIGNATION
BI Lead Developer	DESIGNATION
Data Analyst	DESIGNATION
BI Tableau Developer	DESIGNATION
BI Developer	DESIGNATION
Data Analyst	DESIGNATION
BI	SKILL
JuniorNet Developer	DESIGNATION
Python Developer	DESIGNATION
Python Developer	DESIGNATION
Python Programmer	DESIGNATION
Web Developer	DESIGNATION
Blue Prism	SKILL
UI Path	SKILL
RPA Developer	DESIGNATION
Salesforce Developer Administrator	DESIGNATION
Salesforce Developer Admin	DESIGNATION
Oracle DBA Consultant	DESIGNATION
Salesforce Admin Consultant	DESIGNATION
Salesforce Developer	DESIGNATION
Database Administrator	DESIGNATION
Associate Database Administrator	DESIGNATION
Testing and Post Production Support	DESIGNATION
Senior UI Developer	DESIGNATION
AWS GCP Cloud Engineer	DESIGNATION
DevOps AWS Cloud Engineer	DESIGNATION
AWS Cloud Engineer	DESIGNATION
Salesforce Developer Consultant	DESIGNATION
Salesforce Admin	DESIGNATION
Java J2EE Consultant	DESIGNATION
Salesforce Administrator Developer	DESIGNATION
Salesforce Developer Administrator	DESIGNATION
Salesforce Developer Administrator	DESIGNATION
Salesforce developer	DESIGNATION
Salesforce.com Analyst	DESIGNATION
Senior Peoplesoft Admin and oracle DBA	DESIGNATION
Lead PeopleSoft Admin	DESIGNATION
PeopleSoft Administrator	DESIGNATION
UI Developer	DESIGNATION
UI Web Developer	DESIGNATION
OpenSpan Developer	DESIGNATION
SFDC Developer	DESIGNATION
Jr Web Developer	DESIGNATION
Java Application Developer	DESIGNATION
Salesforce Consultant	DESIGNATION
Senior JAVA J2EE Developer	DESIGNATION
Web Java Developer	DESIGNATION
Splunk Developer Consultant	DESIGNATION
Data and Environment Manager	DESIGNATION
Environment Manager	DESIGNATION
MS Server Developer	DESIGNATION
QA Programmer	DESIGNATION
Splunk Developer	DESIGNATION
TIBCO Developer	DESIGNATION
TIBCO Business Events BW Developer	DESIGNATION
Application Support Engineer	DESIGNATION
Tibco Developer	DESIGNATION
ServiceNow Developer Admin	DESIGNATION
Database Developer	DESIGNATION
Salesforce Certified Developer Admin	DESIGNATION
Senior Net Developer	DESIGNATION
Net Developer	DESIGNATION
Front-end End Developer	DESIGNATION
Database Developer	DESIGNATION
Database Administrator	DESIGNATION
Business Intelligence	DESIGNATION
DW Consultant	DESIGNATION
Business Intelligence Analyst	DESIGNATION
Data Analyst	DESIGNATION
Senior Director Technical Services	DESIGNATION
Senior Manager	DESIGNATION
Senior Consultant	DESIGNATION
Senior Programmer Analyst	DESIGNATION
Independent Consultant	DESIGNATION
Senior Consultant	DESIGNATION
Senior Systems Project Leader	DESIGNATION
Technical Consultant	DESIGNATION
Spark Developer	DESIGNATION
Spark Developer	DESIGNATION
Hadoop Developer	DESIGNATION
Project Manager	DESIGNATION
Senior Director	DESIGNATION
Java Developer	DESIGNATION
Hadoop Developer	DESIGNATION
Senior Programmer Analyst	DESIGNATION
DB Analyst	DESIGNATION
Consultant	DESIGNATION
Project Manager	DESIGNATION
Technical Services	DESIGNATION
RPA Developer	DESIGNATION
Technical Consultant	DESIGNATION
Agile Trainer	DESIGNATION
Agile Coach	DESIGNATION
system Engineer	DESIGNATION
Agile Coach and Instructor	DESIGNATION
Senior ServiceNow Developer Administrator	DESIGNATION
ServiceNow Developer	DESIGNATION
Software Engineer	DESIGNATION
IT Specialist	DESIGNATION
Application Solution Developer	DESIGNATION
Salesforce Admin	DESIGNATION
Application Solution Developer	DESIGNATION
Java Software Engineer	DESIGNATION
JAVA J2EE Developer	DESIGNATION
Java Technical Leader	DESIGNATION
Salesforce Business Analyst	DESIGNATION
Software Lead	DESIGNATION
Technical lead	DESIGNATION
Service Now Developer	DESIGNATION
ADMIN	DESIGNATION
Service Now Developer	DESIGNATION
J2ee Developer	DESIGNATION
Business System Analyst	DESIGNATION
Business Intelligence	DESIGNATION
Java Developer	DESIGNATION
Onsite Coordinator	DESIGNATION
Onsite Coordinator	DESIGNATION
Whittman Hart	ORGANIZATION
Consultant	DESIGNATION
Baker Furniture	ORGANIZATION
Oracle Corporation	ORGANIZATION
JNT UNIVERSITY	ORGANIZATION
future	O
Monitoring Engineer	DESIGNATION
Systems Engineer	DESIGNATION
Lead Developer	DESIGNATION
Software Development Contractor	DESIGNATION
1901 NW Military Hwy	O
2139 Military Hwy	O
210 342 1300	NUMBER
342 1300	NUMBER
Business  System Analyst	DESIGNATION
Business System Analyst	DESIGNATION
Systems Analyst	DESIGNATION
System Analyst	DESIGNATION
Software Analyst	DESIGNATION
Business Analyst	DESIGNATION
Trainee Engineer	DESIGNATION
SalesforceLightning Developer	DESIGNATION
Genfare	ORGANIZATION
Automation Anywhere Developer	DESIGNATION
RPA Trainee	DESIGNATION
Net Developr	DESIGNATION
RPA Trainee	DESIGNATION
UiPath Developer	DESIGNATION
Ruby on Rails	SKILL
Developer	DESIGNATION
Site Minder Admin	DESIGNATION
Software Development Engineer	DESIGNATION
Automation Test Engineer	DESIGNATION
Automation Test Engineer	DESIGNATION
QA Test Engineer	DESIGNATION
Automation Test Engineer 	DESIGNATION
DBA Team Lead	DESIGNATION
Lead Oracle DBA	DESIGNATION
Oracle Database Architect	DESIGNATION
Maintenance DBA	DESIGNATION
Salesforce Consultant	DESIGNATION
Java Developer	DESIGNATION	PERSON
Spring	O
Java Developer	DESIGNATION
spring	O
next quarter	O
Network Engineer	DESIGNATION
Network Support Engineer	DESIGNATION
QlikView Developer	DESIGNATION
Senior Business Analyst	DESIGNATION
Oracle Payables Functional Analyst	DESIGNATION
IT Consultant	DESIGNATION
JNT University	ORGANIZATION
Oracle Applications Analyst	DESIGNATION
Exam Proctor	DESIGNATION
Interim CFO	DESIGNATION
Interim CFO	DESIGNATION
Senior DBA	DESIGNATION
VP of Finance	DESIGNATION
Java Developer	DESIGNATION
QlikView QlikSense Developer	DESIGNATION
QlikSense Developer	DESIGNATION
QlikView Developer	DESIGNATION
VOIP Engineer	DESIGNATION
VOIP Engineer	DESIGNATION
Network Technician	DESIGNATION
BI developer	DESIGNATION
QlikView developer	DESIGNATION
Java J2EE Developer	DESIGNATION
Intern	DESIGNATION
BI developer	DESIGNATION
Wipro	ORGANIZATION
Present	DATE
as	O	STATE_OR_PROVINCE
Clinton Global Initiative	ORGANIZATION
Internship	DESIGNATION
SharePoint 2013 2016	O
decades	O
daily	O
future	O
once	O
Database Developer	DESIGNATION
Database Administrator	DESIGNATION
Business Intelligence	DESIGNATION
DW Consultant	DESIGNATION
Business Intelligence Analyst	DESIGNATION
Data Analyst	DESIGNATION
Web UI Designer	DESIGNATION
Graphic and web Designer	DESIGNATION
Graphic Designer	DESIGNATION
Industrial Visit	DESIGNATION
Research and Data Analyst	DESIGNATION
Research Data Analyst	DESIGNATION
Software Engineer	DESIGNATION
ASP.NET	SKILL
MVC	SKILL
ADO.NET	SKILL
Classic ASP	SKILL
LINQ	SKILL
WCF	SKILL
WPF	SKILL
SILVERLIGHT	SKILL
C# 	SKILL
Service Catalog	SKILL
.NET	SKILL
Change Management	SKILL
VB.NET	SKILL
VB	SKILL
Apex deployment Tools	SKILL
Agile Modeling	SKILL
functional requirement Analysis	SKILL
SFDC Eclipse Plug-ins	SKILL
C	SKILL
C++	SKILL
CPlusplus	SKILL
Workflow Rules	SKILL	MISC
Web Development	SKILL	MISC
T-SQL	SKILL
PL SQL	SKILL
HTML	SKILL
DHTML	SKILL
XML	SKILL
XSLT	SKILL
XSL	SKILL
XSD	SKILL
WSDL	SKILL
Server-Side Scripting	SKILL	MISC
XAML	SKILL
SOAP	SKILL
CSS	SKILL	ORGANIZATION
Web forms	SKILL
Web Services	SKILL
POWERSHELL	SKILL
Jquery	SKILL
JavaScript	SKILL
VB Script	SKILL
SQL SERVER	SKILL
SSIS	SKILL
SSRS	SKILL
Oracle (11g|10g|9i|8i)	SKILL
Win (NT|95|98) 	SKILL
IIS 	SKILL
Microsoft Azure	SKILL
Visual Studio	SKILL
Microsoft.Net	SKILL
React JS	SKILL
TCP IP	SKILL
FTP	SKILL
HTTP	SKILL
Git Hub	SKILL
Team Foundation Server	SKILL
Subversion	SKILL
Visual Source Safe	SKILL
Salesforce CRM	SKILL
Apex Trigger	SKILL
S-Control	SKILL
Migration	SKILL
flows	SKILL
Dashboard Standard and Custom Objects	SKILL
Custom Tabs Schema Builder	SKILL
App Exchange	SKILL
Apex Classes	SKILL
Controllers	SKILL
Apex Web services	SKILL
SOQL	SKILL
SOSL	SKILL
Sales and service cloud	SKILL
Integration	SKILL
Batch Jobs	SKILL
Static resources	SKILL
Reports	SKILL
Eclipse	SKILL
Force.com Developer console	SKILL
Apex Data Loader	SKILL
Force.com Platform Sandbox and Production	SKILL
Force.com Eclipse IDE Plug-in	SKILL
Apex	SKILL
Java	SKILL
AJAX	SKILL	ORGANIZATION
JSON	SKILL
REST	SKILL
Visual force	SKILL
Microsoft Windows	SKILL
Linux	SKILL
Unix	SKILL
MS Access	SKILL
Waterfall model	SKILL
V-model	SKILL
Agile Scrum	SKILL
Apex Data Loader	SKILL
Workbench	SKILL
Force.com explorer	SKILL
Python	SKILL
Python 2.4	SKILL
Unix Shell Scripting	SKILL
SQL	SKILL
Perl	SKILL
EC2	SKILL
S3	SKILL
Glacier	SKILL
Elastic Beanstalk	SKILL
EBS	SKILL
Lambda	SKILL
VPC	SKILL
SNS	SKILL
Hadoop	SKILL
Pyspark	SKILL
HDFS	SKILL
Zookeeper	SKILL
Bootstrap	SKILL
NoSQL	SKILL
Cassandra	SKILL
Sybase	SKILL
Tornado	SKILL
Django	SKILL
Eclipse IDE	SKILL
PyCharm	SKILL
Sublime Text	SKILL
TOAD	SKILL
Windows	SKILL
Agile and Waterfall	SKILL
Jira	SKILL
Agile	SKILL
Waterfall	SKILL
Tortoise SVN	SKILL
Git	SKILL
Ansible	SKILL
ASP.NET core	SKILL
AWS	SKILL
MVC 4 5	SKILL
Entity Framework	SKILL
ASP.NET WebAPI	SKILL
WebAPI	SKILL
Amazon Web Services	SKILL
Microsoft Office	SKILL
ES2015	SKILL
ES6	SKILL
React	SKILL
JSX	SKILL
Redux	SKILL
Angular 2	SKILL
Angular 	SKILL
Typescript	SKILL
HTML5	SKILL
CSS3	SKILL
Modules	SKILL
SASS SCSS	SKILL
SASS	SKILL
SCSS	SKILL
Redux	SKILL
RxJS	SKILL
Webpack	SKILL
Babel	SKILL
Gulp	SKILL
.NET Core	SKILL
Node	SKILL
Express	SKILL
PostgreSQL	SKILL
MongoDB	SKILL
Firebase	SKILL
CSS Modules	SKILL
SharePoint Online	SKILL
SharePoint REST API	SKILL
REST API	SKILL
SharePoint People	SKILL
BA Insight	SKILL
Salesforce	SKILL
ReSharper	SKILL
Atom	SKILL
Visual Studio Code	SKILL
Notepad++	SKILL
Scrum	SKILL
Ruby	SKILL
Rails	SKILL
General Ledger 	SKILL
Accounts Receivable	SKILL
Accounts Payables 	SKILL
Purchasing 	SKILL
i-Procurement	SKILL
Markview 170 Systems	SKILL
Fixed Assets 	SKILL
Cash Management 	SKILL
Costing and Inventory 	SKILL
MS-Windows	SKILL
DOS	SKILL
Mac OS	SKILL
PowerPoint	SKILL
MS Outlook	SKILL
AppDynamics	SKILL
Splunk 	SKILL
Splunk Enterprise	SKILL
Splunk Cloud	SKILL
Splunk ServiceNow	SKILL
Datasets Add-on	SKILL
Timeline - Custom Visualization	SKILL
Splunk App for Zure Monitor	SKILL
Splunk for Excel Export	SKILL
Android	SKILL
Android NDK	SKILL
J2EE	SKILL
JNI	SKILL
Servlets	SKILL
JSP	SKILL
EJB	SKILL
JavaBeans	SKILL
JSF	SKILL
Struts	SKILL
Spring2.0.x	SKILL
Hibernate	SKILL
Spring	SKILL
J Unit	SKILL
JDBC	SKILL
XHTML	SKILL
Adobe Dreamweaver	SKILL
Photoshop	SKILL
Android Studio	SKILL
Net beans	SKILL
SVN	SKILL
Open Office	SKILL
Android SDK	SKILL
Ant	SKILL
Jenkins	SKILL
Mac OS X	SKILL
Ubuntu	SKILL
Web Logic8.1 9.2	SKILL
Apache Tomcat 	SKILL
JBoss 	SKILL
Web Logic	SKILL
Tomcat	SKILL
Log cat	SKILL
DDMS	SKILL
SQLite	SKILL
MySQL	SKILL
Oracle RDBM	SKILL
RDBMS	SKILL
Spring MVC	SKILL
OpenGL	SKILL
Visual Basic	SKILL	PERSON
VBScript	SKILL	PERSON
UFT	SKILL
QTP	SKILL
ALM	SKILL
Quality Center	SKILL
LAN WAN Architecture	SKILL
Frame Relay	SKILL
VPN	SKILL
VLAN	SKILL
VTP	SKILL
NAT	SKILL
PAT	SKILL
STP	SKILL	ORGANIZATION
RSTP	SKILL
PVST	SKILL
MSTP	SKILL
Scripting Languages	O	ORGANIZATION
LAN	SKILL
WAN	SKILL
LAN WAN	SKILL
Cisco Switches	SKILL
Cisco Routers	SKILL
Ironport	SKILL
ASA firewalls	SKILL
Pix	firewalls	SKILL
ASA, Pix firewalls	SKILL
Vmware	SKILL
OSPF	SKILL
IGRP	SKILL
EIGRP	SKILL
RIP	SKILL
MPLS	SKILL
IS-IS	SKILL
BGP	SKILL
Multicasting	SKILL
PAP	SKILL
CHAP	SKILL
Cisco PIX	SKILL
Blue Coat	SKILL
Cisco Works 	SKILL
Wire Shark	SKILL
HRPing	SKILL
Vista	SKILL
XP	SKILL
Cisco IOS	SKILL
IOS XR	SKILL
Juniper M and T Series	SKILL
CISCO	SKILL
Cisco CRS-1	SKILL
GSR	SKILL
Cisco CSM	SKILL
F5 Networks	SKILL
IXIA	SKILL
Spirent	SKILL
Iperf	SKILL
IXChariot	SKILL
Nexus	SKILL
Qualnet Developer	SKILL
OPNET IT GURU	SKILL
Cadence	SKILL
OPNET Modelar	SKILL
juniper net screen	SKILL
Juniper SRX 	SKILL
Pix	SKILL
ASA	SKILL
McAfee Web Gateway	SKILL
TACACS+	SKILL
RADIUS	SKILL
Cisco ACS	SKILL
HSRP	SKILL
GLBP	SKILL
IPAM IRDP	SKILL
NAT	SKILL
SNMP	SKILL
SYSLOG	SKILL
NTP	SKILL	ORGANIZATION
DHCP	SKILL	ORGANIZATION
CDP	SKILL
DNS	SKILL
TFTP	SKILL
FTP Management	SKILL
Open Stack	SKILL
IVRs	SKILL
HLD 	SKILL
LLD documents	SKILL
LLD 	SKILL
SQL Server Management studio	SKILL
Enterprise Manager	SKILL
Profiler	SKILL
Microsoft Visual Source Safe	SKILL
Dot Net	SKILL
Visual studio	SKILL
T-SQL	SKILL
SQL Server Integration Services 	SKILL
SQL Server Reporting Tools 	SKILL
SQL Server Reporting Tools	SKILL
Crystal Reports	SKILL
Power BI	SKILL
Azure	SKILL
Cognos	SKILL
Visual Source Safe	SKILL
Team Foundation Server	SKILL
MS-DOS	SKILL
RedHat	SKILL
PCF	SKILL
CENTOS	SKILL
DEBIAN	SKILL
SUSE	SKILL
MacOS	SKILL
Hudson	SKILL
Bamboo	SKILL
CHEF	SKILL
PUPPET	SKILL
Gradle	SKILL
Docker	SKILL
Kubernetes	SKILL
Mesos	SKILL
OpenShift	SKILL
Nagios	SKILL
 ELK	SKILL
Cloud Watch	SKILL
DynaTrace	SKILL
Bash	SKILL
Shell	SKILL
MongoDB	SKILL
Dynamo DB	SKILL
Apache HTTP	SKILL
Nginx	SKILL
WebSphere	SKILL
WebLogic	SKILL
VMware vSphere ESXi 	SKILL
VMware vSphere 	SKILL
VMware Workstation	SKILL
Oracle Virtual box	SKILL
JBOSS	SKILL
NFS	SKILL
UI Path	SKILL
NET Framework	SKILL
OCR	SKILL
Email Automation	SKILL
Image Recognition	SKILL
Web Recorder	SKILL
Error Handling	SKILL
Window Action	SKILL
SAP	SKILL
Machine Learning	SKILL
AI	SKILL
Artificial Intelligence	SKILL
cognitive development	SKILL
Excel	SKILL
relational databases	SKILL
big data analytics	SKILL
big data	SKILL
website development	SKILL
STORM	SKILL
assurance CM	SKILL
Arena Simulation	SKILL
SharePoint	SKILL
Watson conversation services	SKILL
Oracle eBS	SKILL
Virtual Machines	SKILL
Innotas PPM	SKILL
PPP	SKILL
Oracle eBusiness Suite	SKILL
Oracle MDM	SKILL
Oracle eBusiness Inventory Management	SKILL
Kanban	SKILL
Six Sigma	SKILL
Open Door Policy	SKILL
Smart sheet	SKILL
JIRA boards	SKILL
Trello	SKILL
Assembla	SKILL
MS Office Suite	SKILL
Smart sheet Repository	SKILL
Spotfire	SKILL
Service Now	SKILL
Smart sheet	SKILL
XML Web Services	SKILL
MS Visio	SKILL
visio	SKILL
Blue Prism V-4.2	SKILL
Automation Anywhere 9.0	SKILL
Blue Prism	SKILL
Automation Anywhere 	SKILL
Apex LanguageApex 	SKILL
Oracle E-Business suite EBS	SKILL
Apex Web Service	SKILL
Apex Scheduler	SKILL
Batch Apex	SKILL
Apex Class	SKILL
Visualforce 	SKILL	PERSON
Force.com Apex Explorer	SKILL
Custom labels	SKILL
Tabs	SKILL
Inventory	SKILL
Email Services	SKILL
Dashboards	SKILL
Custom Application and Sandbox data loading	SKILL
Security Controls	SKILL
AppExchange Package 	SKILL
Sandbox data loading	SKILL
Excel Connector	SKILL
AJAX tool kit	SKILL
Force.com Migration Tool	SKILL
Force.com Excel connector	SKILL
HTML Dream weaver	SKILL
DHTML	SKILL
Sub Version	SKILL
XML Schema	SKILL
MS Visual Source Safe	SKILL
Visual Source Safe	SKILL
Visual Studio.Net	SKILL
Ultimate 12	SKILL
SharePoint Designer 	SKILL
Site core CMS	SKILL
Silver light	SKILL
WINFORMS	SKILL
Hyperion	SKILL
SQL Reporting Services	SKILL
PHP	SKILL
Lightning Framework	SKILL
Lightning Components	SKILL
Force.com IDE	SKILL
Triggers	SKILL
Components	SKILL
Analytic Snapshots	SKILL
Custom Objects	SKILL
Standard Objects	SKILL
Apttus CPQ	SKILL
Jitter bit	SKILL
Outlook Express	SKILL
Data Loader	SKILL
RIVA	SKILL
Chatter	SKILL
DB2	SKILL
Dreamweaver	SKILL
Sun Solaris	SKILL
MS Office Products	SKILL
Word	SKILL
Apex Trigger	SKILL
Microsoft Project	SKILL
Outbound Messages	SKILL
MapReduce	SKILL
Hbase	SKILL
Hdfs	SKILL
Sqoop 1.4	SKILL
Spark	SKILL
Sqoop	SKILL
Hive	SKILL
PIG	SKILL
ER Studio v17	SKILL
Erwin	SKILL
Power Sybase Designer	SKILL
Erwin	SKILL
ER Studio	SKILL
Tableau 7	SKILL
SAP BO	SKILL
Tableau	SKILL
RDS	SKILL
Redshift	SKILL
MS Azure Basic	SKILL
Tableau server	SKILL
Tableau Reader	SKILL
SAP Business Objects	SKILL
Unix shell Scripting	SKILL
AWK	SKILL
SED	SKILL
Teradata	SKILL
HP,Mercury	SKILL
Mercury	SKILL
Informatica	SKILL
RAD	SKILL
JAD	SKILL
System Development Life Cycle	SKILL
RUP	SKILL
UML	SKILL
SDLC	SKILL
EIGRP	SKILL
OSPF	SKILL
IP addressing	SKILL
VLSM	SKILL
IP routing principle	SKILL
Knowledge of Border Gateway protocol	SKILL
BGP	SKILL
inter-VLAN routing	SKILL
Spanning tree	SKILL
VTP	SKILL
PAGP	SKILL
LACP	SKILL
Trunk	SKILL
Ether-channel management features	SKILL
Ethernet	SKILL
Fast Ethernet	SKILL
Token Ring	SKILL
FDDI	SKILL
Frame-relay	SKILL
SYSLOG	SKILL
Access Control List	SKILL
DNS	SKILL
ACL	SKILL
Knowledge of Networking Topologies	SKILL
TCP,IP Model	SKILL
SolarWinds	SKILL
RHEL	SKILL
HPUX	SKILL
AIX	SKILL
Sun	SKILL
AWS RDS	SKILL
Exadata	SKILL
Cloud Control	SKILL
RAC	SKILL
Data Guard	SKILL
ASM	SKILL
GoldenGate	SKILL
RAID	SKILL
NetApp	SKILL
Netezza	SKILL
PURE	SKILL
ASH	SKILL
ADDR	SKILL
AWR	SKILL
SQL Profile	SKILL
SQL Baselines	SKILL
IBM Power 795 servers	SKILL
HP ProLiant x86_64 servers	SKILL
IBM Power servers	SKILL
HP ProLiant 	SKILL
Oracle Exadata	SKILL
IBM AIX	SKILL
Oracle Linux OS	SKILL
Windows Server	SKILL
IBM z OS	SKILL
UNIX shell programming	SKILL
VBA	SKILL
COBOL	SKILL
JCL	SKILL
IDCAMS	SKILL
SAS	SKILL
Oracle Data Pump	SKILL
Backup	SKILL
Recovery	SKILL
Validation	SKILL
Cloning	SKILL
DBverify	SKILL
Core Java	SKILL
Angular JS	SKILL
webgl	SKILL
node js	SKILL
NumPy	SKILL
SciPy	SKILL
Pickle	SKILL
PyQT	SKILL
PySide	SKILL
PyTables	SKILL
Data Frames	SKILL
Pandas	SKILL
Matplotlib	SKILL
SQLAlchemy	SKILL
HTTPLib2	SKILL
Urllib2	SKILL
Urillib	SKILL
HTTPLib	SKILL
Soup	SKILL
Py Query	SKILL
Flask	SKILL
Pyramid	SKILL
PyJamas	SKILL
Jython	SKILL
Web2py	SKILL
Brackets	SKILL
WebStorm	SKILL
PyCharm	SKILL
PyScripter	SKILL
Spyder	SKILL
PyStudio	SKILL
PyDev	SKILL
IDLE	SKILL
NetBeans	SKILL
Google Analytics Fiddler	SKILL
Rackspace	SKILL
Amazon EC2	SKILL
Amazon S3	SKILL
Amazon Simple DB	SKILL
Amazon RDS	SKILL
Amazon Elastic Load Balancing	SKILL
Elastic Search	SKILL
Amazon SQS	SKILL
AWS Identity and access management	SKILL
AWS Cloud Watch	SKILL
Amazon EBS 	SKILL
Amazon CloudFront	SKILL
servlets	SKILL
JNDI	SKILL
SQLite3 	SKILL
Redis	SKILL
PostgreSQL	SKILL
CouchDB	SKILL
Apache Web Server	SKILL
Robot	SKILL
Selenium	SKILL	MISC
Junit	SKILL	PERSON
Nose	SKILL
Karma	SKILL
Jasmine	SKILL
Bugzilla	SKILL	PERSON
Pynit	SKILL
Appium	SKILL
Sauce Labs	SKILL
zope	SKILL
PyTest	SKILL
TestNG	SKILL
UDP	SKILL
Restful	SKILL
Github	SKILL
Bamboo	SKILL
TDD	SKILL
BDD	SKILL
Cisco Catalyst switches	SKILL
Palo Alto Firewalls	SKILL
NG	SKILL
NGX	SKILL
Cisco PIX	SKILL
ASA	SKILL
Check Point Nokia Firewalls	SKILL
EIGRP	SKILL
ARP	SKILL
STP	SKILL
Inter VLAN routing	SKILL
Multi-Layer switch	SKILL
Transparent Bridging	SKILL
Cisco IOS	SKILL
Nexus-OS	SKILL
Pix IOS	SKILL
Windows XP	SKILL
Access-lists	SKILL
Routing	SKILL
Switching	SKILL
Subnetting	SKILL
Designing	SKILL
CSU	SKILL
DSU	SKILL
IPSec	SKILL
CSU	SKILL
DSU	SKILL
WEP	SKILL
WAP	SKILL
MPLS	SKILL
VoIP	SKILL
Bluetooth	SKILL
Wi-Fi	SKILL
Cisco CSS	SKILL
ASE Module	SKILL
F5 Networks Big-IP LTM	SKILL
NAT	SKILL
PAT	SKILL
Ipsec	SKILL
ACL	SKILL
IPv4	SKILL
IPv6	SKILL
Gigabit Ethernet	SKILL
TCP dump	SKILL
Leased lines	SKILL
ISDN	SKILL
ATM	SKILL
MPLS	SKILL
SONET	SKILL
DS1	SKILL
DS3	SKILL
Business Intelligence Development Studio	SKILL
BIDS	SKILL
Data Mining Models	SKILL
Bulk Copy Program 	SKILL
SQL Enterprise Manager	SKILL
BCP	SKILL
Data Transformation Services	SKILL
DTS	SKILL
Power BI	SKILL
QlikView	SKILL
Weka	SKILL
Minitab	SKILL
Rational Rose	SKILL
Transact-SQL	SKILL
DAX	SKILL
Apttus	SKILL
Aura Framework	SKILL
JavaScript Controllers	SKILL
Server-side Controllers.	SKILL
Workbench	SKILL
ms sql server	SKILL
WSDL	SKILL	LOCATION
Force.com Eclipse IDE plug-in	SKILL
postman	SKILL
Force.com IDE	SKILL
Windows Vista	SKILL
MS Power BI	SKILL
XML,BI publisher	SKILL
XML publisher	SKILL
BI publisher	SKILL
MS Dynamics	SKILL
Siebel	SKILL
Essbase	SKILL
Cognos	SKILL
MQ-Series	SKILL
Aprimo	SKILL
GIS	SKILL
Scrum Master	SKILL
Qlik Sense	SKILL
Oracle apex	SKILL
SOA	SKILL
Geany	SKILL
Heroku	SKILL
Web Logic	SKILL
Macintosh	SKILL
MS Vision	SKILL
UiPath	SKILL
MS Excel	SKILL
Web API	SKILL
Xamarin forms	SKILL
Telerik	SKILL
MVVM	SKILL
Singleton	SKILL
Dependency Injection	SKILL
Post man	SKILL
.NET UI Controls	SKILL
WPF	SKILL
Robotic Process Automation	SKILL
Pega Openspan	SKILL
IBM Data Power	SKILL
TIBCO	SKILL
Validation Rules	SKILL
WebSphere Integration Developer	SKILL
RDP	SKILL
DameWare	SKILL
RADMIN	SKILL
VNC	SKILL
logMeIn	SKILL
Dameware	SKILL
PCAnywhere	SKILL
Team Viewer	SKILL
SRM	SKILL
Thinapp	SKILL
AbInitio	SKILL
Power BI Desktop	SKILL
OLAP	SKILL
OLTP	SKILL
SQL Server Business Intelligence Studio	SKILL
Query Analyzer	SKILL
Share Point Server	SKILL
Microsoft Project Server	SKILL
SQL Server Integration Services	SKILL
SSIS	SKILL
Turbo Pascal	SKILL
Pascal	SKILL
Dell Boomi	SKILL
SQL Plus	SKILL
PVCS	SKILL
TFS	SKILL
Tortoise SVN	SKILL
Visual Studio Team Services	SKILL
VSTS	SKILL
Applet	SKILL
Lexi Loader	SKILL
Dupe Blocker	SKILL
Juniper Secure Access VPN Appliance	SKILL
Cisco ACE	SKILL
F5 Networks 	SKILL
BIG-IP	SKILL
dot1q	SKILL
MLPPP	SKILL
MPLS	SKILL
Sales cloud	SKILL
Service cloud	SKILL
Marketing cloud	SKILL
Community Cloud	SKILL
Mulesoft	SKILL
DOJO	SKILL
EX-PS	SKILL
JAX-RPC	SKILL
Axis2	SKILL
web sphere	SKILL
Tiles	SKILL
Statistics	SKILL
HANA	SKILL
R	SKILL
R Programming	SKILL
Bluemix	SKILL
networking	SKILL
S-Controls	SKILL
Change sets	SKILL
People Code	SKILL
People Soft	SKILL
PeopleCode	SKILL
PeopleSoft	SKILL
STAT	SKILL
PHIRE	SKILL
PS Query	SKILL
SOAPUI	SKILL
data mover	SKILL
ALM	SKILL
remedy	SKILL
hp quality center	SKILL
Power BI service	SKILL
SSMS	SKILL
SalesForce.com	SKILL
JDK	SKILL
Java Development Kit	SKILL
Solaris	SKILL
NodeXL	SKILL
MVC3	SKILL
Restful web services	SKILL
bulk api	SKILL
metadata spi	SKILL
soap api	SKILL
sandbox	SKILL
sosl	SKILL
Clear Case	SKILL
Docker	SKILL
aws cloud	SKILL
terraform	SKILL
my sql pro	SKILL
stack driver	SKILL
MS FrontPage	SKILL
knockout	SKILL
edit plus	SKILL
clearest	SKILL
clearcase	SKILL
DOS Batch Scripting	SKILL
scala	SKILL
oop	SKILL
log4j	SKILL
slf4j	SKILL
bootstrap js	SKILL
Session Facade	SKILL
Business Delegate	SKILL
Front Controller	SKILL
Service Locator	SKILL
MS Office	SKILL
DTO	SKILL
DAO	SKILL
share point	SKILL
power point	SKILL
UML Class	SKILL
Entity-Relationship and Use Case Diagrams	SKILL
Rational Clear Case	SKILL
Email Templates	SKILL
CTI Adaptors	SKILL	ORGANIZATION
Process builder Visual Flow and Approval Processes	SKILL
ms visio	SKILL
Force.com GUI	SKILL
Force.com Platform	SKILL	ORGANIZATION
Apex Triggers	SKILL	ORGANIZATION
Apex Classes Controllers	SKILL	ORGANIZATION
yuvi	SKILL
cordova	SKILL
Workflow Approvals	SKILL	ORGANIZATION
ionic	SKILL
npm	SKILL
bower	SKILL
grunt	SKILL
gulp	SKILL
d3js	SKILL
backbone.js	SKILL
backbone js	SKILL
db visualizer	SKILL
fire bug	SKILL
photoshop	SKILL
flash	SKILL
subversion	SKILL
perforce	SKILL
vagrant 	SKILL
lambda	SKILL
yaml	SKILL
PUTTY	SKILL
WINSCP	SKILL
AOL	SKILL
INV	SKILL
PO	SKILL
AP	SKILL
GL	SKILL
WMS	SKILL
OM	SKILL
RPG	SKILL
RPG-ILE	SKILL
CL	SKILL
Vsam	SKILL
CICS	SKILL
JCL	SKILL
PRMS	SKILL
Silvon	SKILL
Aldon CMS	SKILL
Hawkeye	SKILL
virtualbox	SKILL
Internet	SKILL
intranet	SKILL
MSIE	SKILL
safari	SKILL
opera	SKILL
chrome	SKILL
firefox	SKILL
mantis	SKILL
windows mobile	SKILL
firebug	SKILL
SPSS Modeler	SKILL
MS DTS	SKILL
data warehouse	SKILL
Google Firebase databases	SKILL
vim	SKILL
Raspberry Pi	SKILL
protractor	SKILL
maven	SKILL
Power Pivot	SKILL
Power View	SKILL
Jmeter	SKILL
Page Object	SKILL
Data Driven	SKILL
cucumber	SKILL
Android SDK	SKILL
VBA Macros	SKILL
Posture SQL	SKILL
WAS	SKILL
IBMNetezza	SKILL
HIS	SKILL
PORT CHANNEL	SKILL
SONET	SKILL
pagp	SKILL
LACP	SKILL
CEF	SKILL
Fiber Optic Circuits	SKILL
PRTG	SKILL
AspectJ	SKILL
spring aop	SKILL
aop	SKILL
tcpmon	SKILL
oracle fusion	SKILL
cloud application	SKILL
nunit	SKILL
olap cubes	SKILL
mdx	SKILL
SQL Navigator	SKILL
SQL Workbench	SKILL
Aqua Data Studio	SKILL
Secure FX	SKILL
Secure CRT	SKILL
FileZilla	SKILL
ariba	SKILL
onenote	SKILL
RMAN	SKILL
Workforce Compensation	SKILL
Workforce Deployment	SKILL
aix	SKILL
oem	SKILL
Sandbox development and Testing	SKILL
Senior	POSITION
Junior	POSITION
etl	SKILL
App Exchange	SKILL
ood	SKILL
subversion	SKILL
vss	SKILL
cast iron	SKILL
lightning pages	SKILL
dashboards	SKILL
reports	SKILL
CSS Dreamweaver	SKILL
Windows batch script	SKILL
windows script	SKILL
wise script	SKILL
FileMon	SKILL
RegMon	SKILL
Process Monitor	SKILL
Process Explorer	SKILL
Orca	SKILL
Wise Package Studio 	SKILL
InstallShield AdminStudio	SKILL
SMS SCCM	SKILL
BMC Software	SKILL
Altiris 	SKILL
BladeLogic 7.x	SKILL
BladeLogic 	SKILL
Citrix	SKILL
LanDesk	SKILL
HPRadia	SKILL
Ghost	SKILL
Microsoft Virtual PC	SKILL
Virtual PC	SKILL
CL Programming	SKILL
Embedded SQL	SKILL
CLP	SKILL
CLLE	SKILL
Free Format RPG	SKILL
RPG IV	SKILL
MiMiX	SKILL
Robot,Scheduler	SKILL
Messenger Plus	SKILL
BRMS	SKILL
ALDON	SKILL
TURNOVER	SKILL
IMPLEMENTER	SKILL
HAWKEYE	SKILL
Menus	SKILL
Display Files	SKILL
Sub-file Programming	SKILL
SOLMAN 	SKILL
TMS	SKILL
CHaRM	SKILL
Retrofit mgmt	SKILL
Retrofit management	SKILL
oracle pl	SKILL
pl	SKILL
service oriented architecture	SKILL
soa	SKILL
ap	SKILL
ar	SKILL
BOM	SKILL
WMS	SKILL
AtTask	SKILL
InterTest	SKILL
HP QC	SKILL
iot	SKILL
internet of things	SKILL
Spring Batch	SKILL
jpa	SKILL
J2EE Design Patterns	SKILL
camel	SKILL
Open LDAP	SKILL
JSTL	SKILL
Reflection-X	SKILL
ITSM	SKILL
HP ITSM	SKILL
Incident	SKILL
Change	SKILL
SLM	SKILL
HP DDM	SKILL
Selenium Web driver	SKILL
Selenium RC	SKILL
Selenium Grid	SKILL
QC	SKILL
groovy	SKILL
use cases	SKILL
actuate	SKILL
data flow	SKILL
Distributed Resource Scheduler 	SKILL
Resource pools	SKILL
Storage DRS	SKILL
DRS	SKILL
vMotion	SKILL
P2V Convertor	SKILL
V2V Convertor	SKILL
 VMware Update Manager	SKILL
Power CLI	SKILL
Site Recovery Manager 	SKILL
WSUS	SKILL
SRM	SKILL
VMRC	SKILL
VEEAM	SKILL
Rack PowerEdge Servers	SKILL
DELL Rack R815	SKILL
DELL Rack 	SKILL
DELL Blades M630	SKILL
DELL Blades	SKILL
DELL Blade Enclosure	SKILL
HP ProLiant Servers	SKILL
HP Blades	SKILL
HP Blades Enclosure	SKILL
Active Directory	SKILL
DHCP Scopes	SKILL
Single sign-on	SKILL
freenas	SKILL
Azure Data Factory	SKILL
Azure Data Lake Store	SKILL
Azure Data Lake Analytics	SKILL
MS Dynamics Axapta	SKILL
Collab Net	SKILL
Tidyverse	SKILL
Tensorflow	SKILL
Keras	SKILL
Bokeh	SKILL
Matplotlib	SKILL
ggplot2	SKILL
dplyr	SKILL
Caret	SKILL
skit-learn	SKILL
skit learn	SKILL
NLTK	SKILL
Linear Regression	SKILL
Generalized-linear models	SKILL
Generalized linear models	SKILL
GLM	SKILL
Covnets	SKILL
Convolution Neural Networks	SKILL
Recurrent Neural Networks  Encoders	SKILL
LSTP	SKILL
Word2Vec	SKILL
K-means	SKILL
C R algorithm	SKILL
Random Forests	SKILL
Boosting 	SKILL
XGBoost	SKILL
Logistic Regression 	SKILL
SVM	SKILL
VAR	SKILL
LDA	SKILL
ARIMA	SKILL
Web ADI	SKILL
New Relic	SKILL
Analytic Snapshots	SKILL
TKPROF	SKILL
Audit table	SKILL
AOTS Remedy Change Management	SKILL
Clarify	SKILL
Tivoli workload scheduler	SKILL
Rogue Wave	SKILL
CORBA	SKILL
Brio Technology	SKILL
BORG	SKILL
Novell Networking	SKILL
WTL	SKILL
ATL	SKILL
clearquest	SKILL
Database Engine Tuning Advisor	SKILL
ECMAScript	SKILL
typescript	SKILL
Illustrator	SKILL
Sketch	SKILL
Appolo	SKILL
GraphQL	SKILL
Brackets	SKILL
EXTJS	SKILL
Spring Boot Micro Services	SKILL
SONOR	SKILL
Sencha	SKILL
Apache Wicket	SKILL
VMware Client	SKILL
vSphere Client	SKILL
Factory	SKILL
Composite	SKILL
ExcelReporting	SKILL
OBIEE	SKILL
Subledger Accounting	SKILL
Financial Statement Generator	SKILL
OUM	SKILL
AIM	SKILL
AGIS	SKILL
iExpense	SKILL
SLA	SKILL
Advanced Pricing	SKILL
Service Contracts	SKILL
Supply Chain Management	SKILL
Oracle EBS Suite Applications	SKILL
Oracle Forms Reports	SKILL
XML Publisher	SKILL
OA Framework	SKILL
Jdeveloper	SKILL
Oracle Enterprise Manager	SKILL
Oracle Data Guard	SKILL
Oracle RAC	SKILL
Momentum	SKILL
Embarcadero DB Power Studio	SKILL
Data Mart	SKILL
Pentium PCs	SKILL
Assignments	SKILL
Roles	SKILL
Profiles	SKILL
Adobe Flash	SKILL
Work Fusion	SKILL
HTML5	SKILL
Vue JS	SKILL
vuejs	SKILL
Jsfiddle	SKILL
Webstrom	SKILL
Tatastrom	SKILL
VF Remoting	SKILL
Juniper SRX	SKILL
Palo Alto NG firewalls	SKILL
Cisco SourceFire	SKILL
Cisco FirePower	SKILL
Cisco ACS	SKILL
Cisco ISE	SKILL
NNMi	SKILL
Cacti	SKILL
Statseeker	SKILL
OpenNMS	SKILL
Stealthwatch	SKILL
Gigamon	SKILL
Panorama	SKILL
Nmap	SKILL
Nessus	SKILL
OpManager	SKILL
PRTG Packet Sniffer	SKILL
JunOS	SKILL
WEP	SKILL
POP3 	SKILL
LADP	SKILL
TNS	SKILL
Core Catalyst	SKILL
ACL- Access Control List	SKILL
SonicWALL	SKILL
RSA SecurID	SKILL
SRX	SKILL
SSG series firewalls	SKILL
CISCO High End Router	SKILL
CISCO Campus Switches	SKILL
Domain servers	SKILL
DNS servers	SKILL
Application servers	SKILL
WINS servers	SKILL
Mail servers	SKILL
Proxy Servers	SKILL
Print Servers	SKILL
FTP servers	SKILL
Avocent Console server	SKILL
i-Procurement	SKILL
i-Store	SKILL
Payables	SKILL
Oracle Purchasing	SKILL
I-Supplier	SKILL
Advance Pricing	SKILL
Shipping	SKILL
Sourcing	SKILL
Procurement Contracts	SKILL
Oracle Accounts	SKILL
Oracle General Ledger	SKILL
Accounts Receivables	SKILL
Oracle Order Management	SKILL
Oracle Inventory	SKILL
ASCP	SKILL
GOP	SKILL
APPWORX	SKILL
Kendo UI	SKILL
VSI-Fax	SKILL
Tiny Term	SKILL
Princeton SoftTech Optim	SKILL
Informix OnLine Dynamic Server	SKILL
Procomm Plus	SKILL
BPWin	SKILL
Bradmark	SKILL
Windows Terminal Server	SKILL
Citrix Metaframe	SKILL
HP Omniback	SKILL
Front Page	SKILL
Exalogic	SKILL
ZFS Storage	SKILL
PeopleCode	SKILL
Component Interface	SKILL
EDI Manager	SKILL
Upgrade Assistant	SKILL
Process Scheduler	SKILL
SQR	SKILL
nVision	SKILL
Tree Manager	SKILL
PSQuery	SKILL
XMLPublisher	SKILL
Django-cms	SKILL
SSO	SKILL
Django-cms plugins	SKILL
Green Plum	SKILL
IntelliJ-IDEA	SKILL
JRUN	SKILL
NoSql Database	SKILL
Adobe Illustrator	SKILL
Anonymous Apex	SKILL
Change Sets deployment	SKILL
React Native	SKILL
Kotlin	SKILL
Espresso	SKILL
Auto rabbit	SKILL
flosum	SKILL
Swift	SKILL
Objective C	SKILL
Facebook SDK	SKILL
test flight	SKILL
PhoneGap	SKILL
Titanium	SKILL
Rhomobile	SKILL
GCD	SKILL
Cocoa	SKILL
Cocoa Touch	SKILL
Foundation Framework	SKILL
UI Kit Framework	SKILL
Obj C Runtime	SKILL
Accelerometer	SKILL
Custom Frameworks	SKILL
Progress View	SKILL
Activity Indicator	SKILL
View	SKILL
Stepper	SKILL
Image View	SKILL
Picker View	SKILL
UI Web View	SKILL
Gesture Recognizer	SKILL
Table View	SKILL
Buttons	SKILL
Navigation Controllers	SKILL
Tabbar Controller	SKILL
UI Labels	SKILL
UI Scroll Views	SKILL
Segmented Control	SKILL
Incident Management	SKILL
ICM	SKILL
Star Schema	SKILL
Snowflake schema 	SKILL
Facts 	SKILL
Dimensions tables	SKILL
Spirent	SKILL
QualNet Developer	SKILL
OPNET IT GURU	SKILL
OPNET Modeler	SKILL
Mercurial	SKILL
pdb	SKILL
Spring IOC	SKILL
ITSM	SKILL
ITIL	SKILL
Spyder	SKILL
Emacs	SKILL
Splunk Web Framework	SKILL
Splunk SEIM	SKILL
Service Level Management	SKILL
SLM	SKILL
RMI	SKILL
CORBA	SKILL
Verity	SKILL
EJB	SKILL
drools	SKILL
Open text Management Server	SKILL
Open text delivery server	SKILL
Kubernetes	SKILL
zabbix	SKILL
Jfrog Artifactory	SKILL
Jfrog	SKILL
Impala	SKILL
MATLAB	SKILL
SAS	SKILL
Flume	SKILL
Zookeeper	SKILL
Arc Sight	SKILL
Tripwire	SKILL
Pentaho	SKILL
Talend	SKILL
flink	SKILL
Sybase Adaptive Server	SKILL
marketo	SKILL
Steelbrick CPQ	SKILL
Metadata API	SKILL
Google Analytics Premium	SKILL
AdWords	SKILL
Web Trends	SKILL
Adobe Adhoc 	SKILL
Adobe Target	SKILL
Google Tag Manager 	SKILL
Dynamic Tag Manager	SKILL
GTM	SKILL
DTM	SKILL
ensighten Enterprise Tag Management	SKILL
Charles	SKILL
Fiddler	SKILL
Adobe Debugger Firebug	SKILL
Observe Point	SKILL
Omnibus	SKILL
stash	SKILL
CA Spectrum	SKILL
Solarwinds	SKILL
Scrutinizer	SKILL
VDC	SKILL
vPC	SKILL
VRF	SKILL
Fabric Path	SKILL
Fabric Extenders	SKILL
Route redistribution	SKILL
Route filtering	SKILL
Route Summarization	SKILL
Inter-VLAN routing 	SKILL
Port Channels	SKILL
Port security	SKILL
Glassfish	SKILL
Oracle virtual box	SKILL
Job DSL plugin	SKILL
Build Pipeline plugin 	SKILL
Delivery Pipeline plugin	SKILL
Glacier	SKILL
Aurora	SKILL
Security Groups	SKILL
DynamoDB	SKILL
IAM	SKILL
Business Interface	SKILL
Business Delegate	SKILL
Service Locator	SKILL
Model View Controller	SKILL
Callidus Conga Composer	SKILL
DocuSign	SKILL
QuickBooks	SKILL
Google Charts	SKILL
Conga Composer	SKILL
Mule soft	SKILL
AppExchange tools	SKILL
Force.com migration tool	SKILL
Jitter bit	SKILL
Oauth 2.0	SKILL
Connected apps	SKILL
QTCherryPy	SKILL
web2py	SKILL
Tornado	SKILL
SaltStack	SKILL
BlueMedora	SKILL
AnthillPro	SKILL
TeamCity	SKILL
DockerSwarm	SKILL
Rapid7 	SKILL
Nexpose	SKILL
Fireeye	SKILL
BitDefender	SKILL
Scribe	SKILL
e-Sign Live	SKILL
Solution manager	SKILL
Oracle DataGuard	SKILL
SQL BackTrack	SKILL
SAP Applications Monitor	SKILL
DBACockpit	SKILL
GL	SKILL
AGIS	SKILL
Sub-ledger Accountinjg	SKILL
SLA	SKILL
Hyperion	SKILL
Rational Unified Process	SKILL
Unified Modeling Language	SKILL
Rapid Application Development 	SKILL
Joint Application Development 	SKILL
RAD	SKILL
JAD	SKILL
Financial Controller	SKILL
Storytelling and Summarization	SKILL
Telecommuting	SKILL
Multitasking	SKILL
HR	SKILL
Payroll	SKILL
UCCE	SKILL
Ether Channel	SKILL
Red gate	SKILL
lit speed	SKILL
Scom	SKILL
Fog lite	SKILL
Queuing	SKILL
Multiprotocol BGP	SKILL
Veritas Clustering	SKILL
Raw disks	SKILL
OPS	SKILL
SRX	SKILL
MX	SKILL
EX Series Routers	SKILL
Internet Explorer	SKILL
Jbuilder	SKILL
Cisco Netflow Analyzer	SKILL
Microsoft SCCM	SKILL
IBM XIV Management studio	SKILL
NetApp DATA ONTAP	SKILL
Citrix Xen desktops	SKILL
Microsoft Hyper-V	SKILL
Hitachi storage	SKILL
Level Platform	SKILL
Netcool	SKILL
Cisco UCS Manager	SKILL
Cisco CIMC	SKILL
Nutanix Prism	SKILL
vCenter Orchestrator	SKILL
vRealize Orchestrator 	SKILL
Standalone convertor	SKILL
Dell Foglight	SKILL
Turbonomics	SKILL
VMTurbo	SKILL
vRealize Log insight	SKILL
Prognosis	SKILL
SIEBEL	SKILL
SIEBEL ANALYTICS	SKILL
Siebel VB	SKILL
DAC	SKILL
DAC LITE	SKILL
DAS 7.2	SKILL
WAS6.1	SKILL
RSA6.1	SKILL
JBoss5.1	SKILL
Mockito	SKILL
PowerMockito	SKILL
Smartbear	SKILL
Channelized links	SKILL
Route redistribution	SKILL
GRE Tunneling	SKILL
Data Driven	SKILL
Keyword Driven	SKILL
Rest Assured	SKILL
Xpath	SKILL
PowerDesigner	SKILL
Embarcadero	SKILL
Coolgen	SKILL
Sun One Studio	SKILL
Scrum v-model	SKILL
Eviews	SKILL
Advanced MS Excel	SKILL
Neural Network	SKILL
Cluster Analysis	SKILL
Conjoint Analysis	SKILL
Sentiment Analysis	SKILL
Scaled Agile Framework	SKILL
Mock Up Screens	SKILL
Lucid Chart	SKILL
Balsamiq	SKILL
Swagger	SKILL
Slicing	SKILL
Dicing	SKILL
Drill Up	SKILL
Drill Down	SKILL
Pivot	SKILL
CommVault	SKILL
Data Domain	SKILL
Nortel	SKILL
IBM Sterling Commerce	SKILL
IBM Curam	SKILL
Cayenta	SKILL
WijmokendoUI	SKILL
Wiki	SKILL
Cobertura	SKILL
Application Object Library	SKILL
AOL	SKILL
CMDB	SKILL
Microsoft powerpoint	SKILL
powerpoint	SKILL
caret	SKILL
glmnet	SKILL
forecast	SKILL
xgboost	SKILL
Keras	SKILL
Pytorch	SKILL
theano	SKILL
Sk-learn	SKILL
Cross Validation	SKILL
Walk Forward Estimation	SKILL
AIC Criterions	SKILL
BIC Criterions	SKILL
AIC,BIC Criterions	SKILL
Grid Search	SKILL
Random Forests	SKILL
Support Vector Machines	SKILL
Gradient Boosting	SKILL
XGB	SKILL
DOM parsers	SKILL
SAX parsers	SKILL
Performance Point Server	SKILL
Apache ActiveMQ	SKILL
MOQ	SKILL
NASCO	SKILL
Android Emulator	SKILL
Pega Systems	SKILL
Netscout nGenius Performance Manager	SKILL
Infinistream	SKILL
UiPath Orchestrator	SKILL
Tru64	SKILL
FreeBSD	SKILL
OpenBSD	SKILL
SCO 	SKILL
Openserver	SKILL
Red Hat Linux	SKILL
Altova XML Spy	SKILL
Pivital Cloud Foundry	SKILL
Spring Micro Services	SKILL
WEDO RAID	SKILL
Osprey TCG	SKILL
Snowball	SKILL
Npm	SKILL
ReportLab	SKILL
JMP PRO	SKILL
RPGLE	SKILL
CLLE	SKILL
Asmcmd	SKILL
Active Dataguard	SKILL
Maximo	SKILL
Kafka	SKILL
Avro	SKILL
Parquet	SKILL
Impala	SKILL
Hortonworks	SKILL
ExoPlayer	SKILL
IKE	SKILL
TACACS+	SKILL
Matplotlib	SKILL
Jfrog	SKILL
Object Oriented Programming	SKILL
Accurev	SKILL
Wing IDE	SKILL
Beyond Compare Tera Term	SKILL
SQL Server Query Editor	SKILL
Tuxedo	SKILL
PeopleSoft Update Manager	SKILL
PUM	SKILL
unified navigation	SKILL
FSCM	SKILL
PO	SKILL
ELM	SKILL
custom cloud	SKILL	ORGANIZATION
HRMS	SKILL
Visualforce Controllers	SKILL
Visualforce 	SKILL
Salesforce Lightning Design System	SKILL
Lighting Controllers	SKILL	ORGANIZATION
CTI	SKILL	ORGANIZATION
UML Tools	SKILL	ORGANIZATION
mac	SKILL
beautiful soup	SKILL
Sandbox development 	SKILL
sandbox testing	SKILL
Translation Workbench	SKILL
APM	SKILL
Wily Power Packs for MQ	SKILL
SPM	SKILL
Rational Software Architecture	SKILL
Gherkin	SKILL
soapUI	SKILL
Expression Blend	SKILL
SauceLabs	SKILL
team forge	SKILL
Varitas Clustererd	SKILL
Ldoms	SKILL
vnc	SKILL
winscp	SKILL
Metrics	SKILL
scrum management	SKILL
vb scripting	SKILL
qa management	SKILL
QuickBooks	SKILL
Unity 3D	SKILL
Adobe	SKILL
Kibana	SKILL
water fall	SKILL
scrum master	SKILL
pylint	SKILL
couhbase	SKILL
couh base	SKILL
redis	SKILL
ATLASSIAN	SKILL
iron	SKILL
OPM Costing	SKILL
ASCP	SKILL
APCC	SKILL
Demantra	SKILL
HtmlParser	SKILL
html parser	SKILL
Arch Linux	SKILL
open stock	SKILL
jmeter	SKILL
anaconda	SKILL
maria db	SKILL
panda data frame	SKILL
telnet	SKILL
remote access vpn	SKILL
Strobe	SKILL
cics	SKILL
lima	SKILL
endevor	SKILL
ms	SKILL
vss	SKILL
JMP PRO	SKILL
nodexl	SKILL
uci net	SKILL
pyjamas	SKILL
Implementer	SKILL
Turnover	SKILL
aldon	SKILL
SQLRPGLE	SKILL
SQLCBLLE	SKILL
mapics	SKILL
eAM	SKILL
Enterprise Assert Management	SKILL
Travis CI	SKILL
Skuid	SKILL
Form Assembly	SKILL
Qualtrics	SKILL
kanban	SKILL
Import Wizard	SKILL
Single-Sign-On Integration	SKILL
TIBCO BusinessWorks	SKILL
TIBCO Administrator 	SKILL
TIBCO Business Connect	SKILL
TIBCO Hawk 	SKILL
TIBCO Instream	SKILL
TIBCO Translator	SKILL
SQUIRREL	SKILL
Adobe Captivate 3	SKILL
CorelDraw	SKILL
glassfish	SKILL
jelly	SKILL
Oracle Fusion Middleware	SKILL
razor	SKILL
winform	SKILL
Cron scheduling	SKILL
oracle tuning pack	SKILL
wordpress	SKILL
http-server	SKILL
Microsoft Azure Emulator	SKILL
Oracle Warehouse	SKILL
oracle designer	SKILL
quest	SKILL
UWQ	SKILL
Spiral	SKILL
dimensiontable	SKILL
winscp	SKILL
Ember.js	SKILL
Rest WCF Services	SKILL
Wolfram Mathematica	SKILL
lingo	SKILL
Alibaba Cloud	SKILL
Load Balancing technologies	SKILL
Automation	SKILL
debugging	SKILL
Treasury	SKILL
Account Receivables	SKILL
STATSPACK	SKILL
FrameMaker	SKILL
drupal	SKILL
joomla	SKILL
VISUAL SOURCE SAFE	SKILL
WxPython	SKILL
Tkinter	SKILL
Elasticsearch	SKILL
SILK Central HP Application Life Management	SKILL
Data Dimensions	SKILL
Oracle AME	SKILL
revenue management	SKILL
Stress testing	SKILL
enterprise manager cloud control	SKILL
rac 12 c	SKILL
Dundas	SKILL
pom	SKILL
source tree	SKILL
qtp	SKILL
uft	SKILL
TensorFlow	SKILL
Keras	SKILL
Scikit-Learn	SKILL
Pytorch	SKILL
fedora	SKILL
sea born	SKILL
Vcenter Update manager	SKILL
HA	SKILL
DRS	SKILL
Storage Vmotion	SKILL
Vapp	SKILL
ksh	SKILL
Remedy Midtier	SKILL
Remedy Migrator	SKILL
BEA Web Logic	SKILL
Life ray Portal	SKILL
IBM Rational Clear Case	SKILL
gunicorn	SKILL
Sencha ExtJs	SKILL
NetworkMinor	SKILL
Forefront Identity manager	SKILL
Animate CC	SKILL
Delphi	SKILL
Ankhsvn Subversion	SKILL
data reports	SKILL
Infragestic Control	SKILL
Symantec products	SKILL
CircleCI	SKILL
TravisCI	SKILL
Codeship	SKILL
Coveralls	SKILL
GoLang	SKILL
FreeRTOS	SKILL
OpenWRT	SKILL
oracle e business suite	SKILL
integration	SKILL
c#.net	SKILL
ITSM Suite	SKILL
BEANS	SKILL
Phusion Passenger	SKILL
DBArtisan	SKILL
VersionOne	SKILL
craft	SKILL
trello	SKILL
pi databases	SKILL
Hyperion	SKILL
Advanced SQL Tuning	SKILL
Business Objects	SKILL
Exchange assistant	SKILL
eFileCabinet	SKILL
RecordMinder	SKILL
FileHold	SKILL
Eye tracking	SKILL
Think Aloud	SKILL
IBM Rational Quality Manager	SKILL
BODS	SKILL
Sonarqube	SKILL
Telerik Test Studio	SKILL
watin	SKILL
Helsinki	SKILL
Geneva	SKILL
Zeke Scheduler	SKILL
Retrofit	SKILL
glide	SKILL
picaso	SKILL
dagger	SKILL
okhttp	SKILL
Cmake	SKILL
Xamarin	SKILL
CA Site Minder	SKILL
urllib2	SKILL
IBM BPM	SKILL
addm	SKILL
adrci	SKILL
dri	SKILL
sta	SKILL
ssa	SKILL
TKProf	SKILL
XDOCUMENT	SKILL
Phire	SKILL
Stat tools	SKILL
VRangerPro	SKILL
Veeam backup	SKILL
foxpro	SKILL
Supplier Life Cycle Management	SKILL
Customer Data Hub	SKILL
bluecoat	SKILL
DoD Secret Clearance	SKILL
Data Guard	SKILL
Data Migration	SKILL
Real Application Clustering	SKILL
eCommerce	SKILL
Tuxedo	SKILL
Spotlight	SKILL
Foglight	SKILL
IAM	SKILL
Glacier	SKILL
Cloud Formation	SKILL
OpsWorks	SKILL
Web Logic Server	SKILL
SEQUEL	SKILL
OCL	SKILL
I-Nav	SKILL
Empower	SKILL
Sofi	SKILL
Loan Appx	SKILL
Loan App	SKILL
Sassy	SKILL
MLS Systems	SKILL
Interaction Composer	SKILL
N-tier application architecture	SKILL
Securefx	SKILL
Factory pattern	SKILL
VoIP	SKILL
PoE	SKILL
PLSQL packages	SKILL
esql	SKILL
HIPAA	SKILL
PLSQL	SKILL
HEDIS	SKILL
Operating systems	SKILL
MS DOS	SKILL
ETL	SKILL
Mongoosejs	SKILL
cosmos	SKILL
Tibco virtualization tool	SKILL
Creational Patterns	SKILL
Structural Patterns	SKILL
Multithreading	SKILL
Camera API	SKILL
Facebook API	SKILL
Crashlytics	SKILL
BMC Remedy	SKILL
gcp	SKILL
Symantec Enterprise Security	SKILL
Tivoli CCMDB	SKILL
Tivoli 	SKILL
HPE ProLiant DL Series	SKILL
Dell PowerEdge	SKILL
ECE	SKILL
Engineer	DESIGNATION
Devops	SKILL
workflow and approvals	SKILL
workflow approvals	SKILL
IBM RAD	SKILL
Water Fall	SKILL
Certified salesforce Developer	CERTIFICATION
shell scripting	SKILL
clear quest	SKILL
IBM Clear Quest	SKILL
Lean Testing	SKILL
SOAP UI	SKILL
CVS	SKILL
VSS	SKILL
CodedUI	SKILL
net	SKILL
websphere6	SKILL
Eclipse plug-in	SKILL
Custom Standard Objects	SKILL
Apache Tomcat	SKILL
Agile Methodology	SKILL
Waterfall Methodology	SKILL
Micro Strategy	SKILL
SQL Developer	SKILL
Portal	SKILL
ELM	SKILL
FSCM	SKILL
Campus Solutions	SKILL
CRM	SKILL
XML Publisher	SKILL
Integreation Broker	SKILL
Change Assistant	SKILL
PeopleSoft Security	SKILL
Employee of the Quarters from Clients	O	ORGANIZATION
Database	SKILL	ORGANIZATION
Work Flows	SKILL
Case Management Automation	SKILL
Force.com Data Loader	SKILL
Win Runner	SKILL
Quick Test Professional	SKILL
IBM DataPower	SKILL
IBM UrbanCode Deploy	SKILL
Contivo Analyst	SKILL
IBM iSeries Access for Windows	SKILL
Content Organizing	SKILL
Team Building	SKILL
Adaptability	SKILL
Problem-solving	SKILL
Time Management	SKILL 
Public Speaking	SKILL
Networking 	SKILL
Certified Salesforce Administrator	CERTIFICATION
Certified  Salesforce Administrator	CERTIFICATION
Cloud Data Wizard	SKILL
Dupe Blocker	SKILL
Dupe Catcher	SKILL 
Conga Composer	SKILL
Popup Alerts	SKILL 
Outlook and Office 365 Connector Plugin	SKILL
Survey Force	SKILL 
Mass Lead Convertor	SKILL 
Mass Update	SKILL 
Mass Delete	SKILL
Google Maps Integrator	SKILL
PL SQL Web Toolkit	SKILL
Cognos 10 BI tools	SKILL
Report Studio	SKILL
Analysis Studio	SKILL
Query Studio	SKILL
Cognos Connection	SKILL
Data Transformation Services	SKILL
Import export wizard	SKILL
Bulk Insert	SKILL 
BCP	SKILL 
Data Warehousing	SKILL
K-means	SKILL
K means	SKILL
C&R algorithm	SKILL 
Random Forests	SKILL
Boosting	SKILL 
XGBoost	SKILL
CR algorithm	SKILL
ggplot2	SKILL 
dplyr	SKILL 
Caret	SKILL
skit-learn	SKILL
skit learn	SKILL
Restful web service	SKILL
PHP	SKILL
JQuery	SKILL
Oracle9i	ORGANIZATION
Golden Gate	SKILL
TechnologyFrom	O	ORGANIZATION
Eclipse IDE Plug-in	SKILL
Apex Batch Classes	SKILL
S Controls	SKILLS
Analytic Snapshots	SKILL
VSTS	SKILL
Windows XP	SKILL
HTML	SKILL
CSS	SKILL
C	SKILL
C++	SKILL
Server-side Controllers	SKILL
Server side Controllers	SKILL
Microsoft Windows platforms	SKILL
WSDL	SKILL
CERTIFICATIONS Certified Salesforce	O	ORGANIZATION
Anantapur	LOCATION	PERSON
Jhon High School	ORGANIZATION
Repalle	LOCATION	PERSON
Guntur	LOCATION	PERSON	
Kakinada	LOCATION	ORGANIZATION
Postgre  MS Access	SKILL
NoSql Databases	SKILL
Data Transformation Services	SKILL
DTS	SKILL
SQL Server Reporting Services	SKILL
SQL Server Integration Services	SKILL
Chennai	LOCATION	ORGANIZATION
Tiruchengode	LOCATION	ORGANIZATION
VVHSS	ORGANIZATION	LOCATION
UNIX Linux Shell Scripting Bash	SKILL
IIS	SKILL
Microsoft Windows	SKILL
AJAX	SKILL
Data Wrangling	SKILL	LOCATION
Rational Application Developer	SKILL
Computer Science	SKILL	ORGANIZATION
I	O	ORGANIZATION
win-runner	SKILL
load runner	SKILL
ecatt	SKILL
ms- access	SKILL
le	SKILL
windows nt	SKILL
css	SKILL
Twitter bootstrap	SKILL
Sublime and GIT & Subversion	SKILL
Sublime and GIT Subversion	SKILL
spring web flow	SKILL
Servlets	SKILL
Pandas data frame	SKILL
PyUnit	SKILL
python-runner	SKILL
LDAP	SKILL
X Path	SKILL
RUP Methodology	SKILL
AngularJS	SKILL
ASP Net	SKILL
SAP BW	SKILL
Mango DB	SKILL
C#.NET	SKILL
Blue-Prism	SKILL
Force.com Explorer	SKILL
Test Classes	SKILL
Change Set	SKILL
Sales cloud	SKILL
Service cloud	SKILL
Apex Custom Controllers and Extension	SKILL
Apex Explorer Salesforce connect	SKILL
Water Management	SKILL	
Sugar Technology	SKILL
Systems Science Engineering	SKILL
Telecommunication	SKILL
Textile Chemistry	SKILL
Textile Engineering	SKILL
Textile Production	SKILL
Textile Technology	SKILL
Thermal Engineering	SKILL
Tool Engineering	SKILL
Transportation Engineering	SKILL
Printing Technology	SKILL
Printing and Packaging Technology	SKILL
Production Engineering	SKILL
Production Engineering and Management	SKILL
Pulp and Paper Technology	SKILL
Rubber Technology	SKILL
Safety and Fire Engineering	SKILL
Safety and Occupational Health Engineering	SKILL
Software Engineering	SKILL
Skill Technology	SKILL
Petrochemical Engineering	SKILL
Petroleum Engineering	SKILL
Pharmaceutical Technology	SKILL
Planning Engineering	SKILL
Plastic Engineering	SKILL
Polymer Technology	SKILL
Power Electronics	SKILL
Power Engineering	SKILL
Precision Manufacturing	SKILL
Printing Graphics and Packaging	SKILL
Mineral Engineering	SKILL
Mining Engineering	SKILL
Mining Machinery Engineering	SKILL
Nano Technology Engineering	SKILL
Nano Technology and Robotics	SKILL
Naval Architecture and Marine Engineering	SKILL
Naval Architecture and Ocean Engineering	SKILL
Nuclear Engineering	SKILL
Oil and Paint Technology	SKILL
Paint Technology	SKILL
Mechanical Engineering - Desgin and Manufacturing	SKILL
Mechanical Production Engineering	SKILL
Mechanical and Automation Engineering	SKILL
Mechanical and Industrial Engineering	SKILL
Mechanics	SKILL
Mechatronics Engineering	SKILL
Medical Electronics	SKILL
Metallurgical and Materials Engineering	SKILL
Micro-Biology and Immunology Engineering	SKILL
Jute and Fiber Technology	SKILL
Leather Technology	SKILL
Manufacturing Process and Automation Engineering	SKILL
Manufacturing Engineering	SKILL
Man Made Fiber Technology	SKILL
Marine Engineering	SKILL
Mechanical Automobile	SKILL
Mathematics and Computing Engineering	SKILL
Materials Science and Technology	SKILL
Mechanical Engineering	SKILL
Industrial Biotechnology	SKILL
Industrial Desgin	SKILL
Industrial Engineering	SKILL
Industrial and Production Engineering	SKILL
Information Science Engineering	SKILL
Information Technology	SKILL
Information and Commuunication Technology	SKILL
Instrumentation Engineering	SKILL
Instrumentation Technology	SKILL
Instrumentation and Control Engineering	SKILL
Enviromental Engineering	SKILL
Fashion Technology	SKILL
Fashion and Apparel Engineering	SKILL
Food Processing Technology	SKILL
Food Technology	SKILL
Food and Biochemical Engineering	SKILL
Genetic Engineering	SKILL
Geo informatics	SKILL
Geosciences and Remote Sensing	SKILL
Geotechnical Engineering	SKILL
Electronics and Computer Engineering	SKILL
Electronics and Communication Engineering	SKILL
Electronics and Electrical Communication	SKILL
Electronics and Telecommunication Engineering	SKILL
Electronics and Power Engineering	SKILL
Electronics and Instrumentation Engineering	SKILL
Energy Management	SKILL
Engineering Chemistry	SKILL
Dairy Technology	SKILL
Engineering Physics	SKILL
Electrical Engineering	SKILL
Electrical and Communications Engineering	SKILL
Electrical and Instrumentation Engineering	SKILL
Electronics Engineering	SKILL
Electronics Control Systems Engineering	SKILL
Electrical and Electronics Engineering	SKILL
Electronics Product Design Technology	SKILL
Electronics Engineering- Design and Manufacturing	SKILL
Computer Science Engineering	SKILL
Chemical Ceramic Technology	SKILL
Ceramics and Cement Engineering	SKILL
Electronics and Biomedical Engineering	SKILL
Chemical and Polymer Engineering	SKILL
Civil Engineering	SKILL
Chemical Engineering	SKILL
Civil and Structural Engineering	SKILL
Civil Environmental Engineering	SKILL
Construction Technology	SKILL
Bio Engineering	SKILL
Construction Technology and Management	SKILL
Biochemical Engineering	SKILL
Bio-Medical and Instrumentation Engineering	SKILL
Biomedical Engineering	SKILL
Biological Sciences and Bioengineering	SKILL
Biotechnology and Biochemical Engineering	SKILL
Biotechnology Engineering	SKILL
Carpet and Textile Technology	SKILL
Aeronautical Engineering	SKILL
Ceramic Engineering	SKILL
Building and Construction Engineering	SKILL
Agricultural Engineering	SKILL
Aerospace Engineering	SKILL
Agricultural and Food Engineering	SKILL
Agricultural and Irrigation Engineering	SKILL
Automotive Engineering	SKILL
Automobile Engineering	SKILL
Automation and Robotics	SKILL
Applied Electronics and Instrumentation Engineering	SKILL
Aircraft Manufacturing and Maintenance Engineering	SKILL
Aerospace Engineering	SKILL
Philosophy	SKILL
Pharmaceutical Analysis	SKILL
Digital Design	SKILL
English	SKILL
Sciences	SKILL
Geology	SKILL
Pharmaceutical Regulatory Affairs	SKILL
Anthropology	SKILL
Hospitality and Tourism	SKILL
Pharmaceutics	SKILL
History	SKILL
Pharmaceutical Biotechnology	SKILL
Planning Engineering	SKILL
Nephrology	SKILL
Political Science	SKILL
Physics	SKILL
Fashion Design	SKILL
Textile Production	SKILL
Service Management	SKILL
Arts	SKILL
Systems Management	SKILL
Rural Marketing	SKILL
Botany	SKILL
Jute and Fiber Technology	SKILL
Precision Manufacturing	SKILL
Silk Technology	SKILL
Printing Graphics and Packaging	SKILL
Sugar Technology	SKILL
Manufacturing Process and Automation Engineering	SKILL
Risk Management	SKILL
Pulp and Paper Technology	SKILL
Industry Integrated	SKILL
General Science	SKILL
Man Made Fiber Technology	SKILL
Printing Technology	SKILL
Rubber Technology	SKILL
Carpet and Textile Technology	SKILL
Sustainable Development	SKILL
Printing and Packaging Technology	SKILL
Polymer Technology	SKILL
Manufacturing Engineering	SKILL
Fashion and Apparel Engineering	SKILL
Enterprise Journalism	SKILL
Materials Science and Technology	SKILL
Oil and Paint Technology	SKILL
Engineering Chemistry	SKILL
Paint Technology	SKILL
Mining Machinery Engineering	SKILL
Zoology	SKILL
Mineral Engineering	SKILL
Systems Science Engineering	SKILL
Textile Chemistry	SKILL
Instrumentation Technology	SKILL
Plastic Engineering	SKILL
Safety and Fire Engineering	SKILL
Thermal Engineering	SKILL
Pharmaceutical Technology	SKILL
Psychology	SKILL
Global Journalism	SKILL
Broadcast Journalism	SKILL
Pharmacy	SKILL
Business Design	SKILL
Business Design and Innovation Management	SKILL
Production Engineering and Management	SKILL
Industrial Engineering	SKILL
Biotechnology	SKILL
E-Business	SKILL
Production Engineering	SKILL
Telecommunication	SKILL
Electronics and Biomedical Engineering	SKILL
Naval Architecture and Ocean Engineering	SKILL
Naval Architecture and Marine Engineering	SKILL
Medical Electronics	SKILL
Food and Biochemical Engineering	SKILL
Journalism Design and Graphics	SKILL
Digital and Interactive Media Journalism	SKILL
Textile Technology	SKILL
News Reporting and Writing	SKILL
International Marketing	SKILL
Food Processing and Technology	SKILL
Public Relations and Advertising	SKILL
Chemistry	SKILL
Instrumentation and Control Engineering	SKILL
Metallurgical and Materials Engineering	SKILL
Animation Film Making	SKILL
Micro-Biology and Immunology Engineering	SKILL
Visual Effects	SKILL
Engineering Physics	SKILL
Mass Communication	SKILL
Nano Technology Engineering	SKILL
Film Television Digital Video Production	SKILL
Product Design	SKILL
Bio-Medical and Instrumentation Engineering	SKILL
Bio Engineering	SKILL
Game Art and Design	SKILL
Journalism	SKILL
Web Designing and Multimedia	SKILL
Nano Technology and Robotics	SKILL
Industrial Biotechnology	SKILL
Sales	SKILL
Computer Science	SKILL
Information Science Engineering	SKILL
Ceramics and Cement Engineering	SKILL
Retail Management	SKILL
Environment Management	SKILL
Financial Management	SKILL
Petroleum Management	SKILL
Marine Engineering	SKILL
Hospital Management	SKILL
Pharmaceutical Management	SKILL
Family Business Management	SKILL
Textile Management	SKILL
Leather Technology	SKILL
Chemical Ceramic Technology	SKILL
Infrastructure Management	SKILL
Product Management	SKILL
Power Engineering	SKILL
Power Electronics	SKILL
Mechanical Engineering- Design and Manufacturing	SKILL
Hotel Management	SKILL
Film Making	SKILL
Geotechnical Engineering	SKILL
Interior Design	SKILL
Construction Management	SKILL
Forestry Management	SKILL
Electronics Product Design Technology	SKILL
Materials Management	SKILL
Business Strategy	SKILL
Civil Environmental Engineering	SKILL
Strategic Management	SKILL
Transportation Engineering	SKILL	
Electronics Engineering- Design and Manufacturing	SKILL
Biochemical Engineering	SKILL
Graphic Designing	SKILL
Geo informatics	SKILL
Power Management	SKILL
Telecom Management	SKILL
Apparel Management	SKILL
Health Care Management	SKILL
Industrial and Production Engineering	SKILL
Chemical and Polymer Engineering	SKILL
Instrumentation Engineering	SKILL
Global Operations	SKILL
Communication Management	SKILL
Water Management	SKILL
Environmental Engineering	SKILL
Mechanical Production Engineering	SKILL
Ceramic Engineering	SKILL
Construction Technology	SKILL
Technology Management	SKILL
Construction Technology and Management	SKILL
Economics	SKILL
Tool Engineering	SKILL	
Information Systems Management	SKILL
Mathematics and Computing Engineering	SKILL
Electrical and Instrumentation Engineering	SKILL
Mechanical Automobile	SKILL
Entrepreneurship	SKILL
Genetic Engineering	SKILL
Hospitality Management	SKILL
Safety and Occupational Health Engineering	SKILL
Biological Sciences and Bioengineering	SKILL
Food Technology	SKILL
Industrial Marketing	SKILL
Animation and Design	SKILL
Rural Management	SKILL
Mechanical and Automation Engineering	SKILL
Capital Market	SKILL
Disaster management	SKILL
Mechanical and Industrial Engineering	SKILL
Energy Management	SKILL
Agricultural Engineering	SKILL
Business Analytics	SKILL
International Business Communication	SKILL
Occupational Therapy	SKILL
Textile Engineering	SKILL
Corporate Management	SKILL
Agriculture Business Management	SKILL
Electronics and Media Technology	SKILL
Dairy Technology	SKILL
Fashion Technology	SKILL
Rheumatology	SKILL
Metallurgical Engineering	SKILL
Banking and Insurance	SKILL
Labour Law	SKILL
Biotechnology and Biochemical Engineering	SKILL
Mining Engineering	SKILL
Biomedical Engineering	SKILL
Electronics and Electrical Communication	SKILL
Oncology	SKILL
Logistics and Supply Chain Management	SKILL
Agricultural and Irrigation Engineering	SKILL
Urology	SKILL
Software Engineering	SKILL
Media Management	SKILL
Cyber Law	SKILL
Aviation Management	SKILL
Pathology	SKILL
Banking Management	SKILL
Electronics Control Systems Engineering	SKILL
Industrial Design	SKILL
Electronics and Power Engineering	SKILL
Tourism	SKILL
Commercial Law	SKILL
Otolaryngology ear nose and throat	SKILL
Civil and Structural Engineering	SKILL
Automotive Engineering	SKILL
Agricultural and Food Engineering	SKILL
Applied Electronics and Instrumentation Engineering	SKILL
Administrative Management	SKILL
Endocrinology	SKILL
Building and Construction Engineering	SKILL
Petrochemical Engineering	SKILL
Nuclear Engineering	SKILL
Physiology	SKILL
General Medicine and Surgery	SKILL
Information and Communication Technology	SKILL
Ayurveda	SKILL
General Management	SKILL
Ophthalmology	SKILL
Biotechnology Engineering	SKILL
Physiotherapy	SKILL
Electronics and Instrumentation Engineering	SKILL
Homeopathy	SKILL
Electronics Engineering	SKILL
Financial Market	SKILL
Electronics and Computer Engineering	SKILL
Computer Engineering	SKILL
Chemical Engineering	SKILL
International Business	SKILL
Law	SKILL
Electronics and Telecommunication Engineering	SKILL
Aircraft Manufacturing and Maintenance Engineering	SKILL
Dentistry	SKILL
Marketing Management	SKILL
Radiology	SKILL
Petroleum Engineering	SKILL
Automobile Engineering	SKILL
Information Technology	SKILL
Aeronautical Engineering	SKILL
Automation and Robotics	SKILL
Electrical and Electronics Engineering	SKILL
Electrical and Communications Engineering	SKILL
Anatomy	SKILL
Banking and Finance	SKILL
Architecture Engineering	SKILL
Mechatronics Engineering	SKILL
Computer Science Engineering	SKILL
Aerospace Engineering	SKILL
Mechanical Engineering	SKILL
Civil Engineering	SKILL
Electrical Engineering	SKILL
Human Resource Management	SKILL
Finance	SKILL
Sales and Marketing	SKILL
Electronics and Communication Engineering	SKILL
Operations Management	SKILL
2011	DATE	ORGANIZATION
Jan	DATE	ORGANIZATION
Feb	DATE	ORGANIZATION
Mar	DATE	ORGANIZATION
Apr	DATE	ORGANIZATION
May	DATE	ORGANIZATION
Jun	DATE	ORGANIZATION
Jul	DATE	ORGANIZATION
Aug	DATE	ORGANIZATION
Sep	DATE	ORGANIZATION
Oct	DATE	ORGANIZATION
Nov	DATE	ORGANIZATION
Dec	DATE	ORGANIZATION